AAAAATAGCAC -> AAAATAGCACT
AAAACAACGCA -> AAACAACGCAG
AAAACCCTTGT -> AAACCCTTGTC
AAAACCTGGGT -> AAACCTGGGTT
AAAAGTCAGTC -> AAAGTCAGTCC
AAAATAGCACT -> AAATAGCACTC
AAAATCAACAC -> AAATCAACACA
AAACAACGCAG -> AACAACGCAGC
AAACAACGCCG -> AACAACGCCGT
AAACAATTCCC -> AACAATTCCCG
AAACAGCGACG -> AACAGCGACGT
AAACATAATAG -> AACATAATAGG
AAACATCCAGA -> AACATCCAGAT
AAACCCTTGTC -> AACCCTTGTCT
AAACCTGGGTT -> AACCTGGGTTG
AAACGCGTAAA -> AACGCGTAAAA
AAACTAGATGC -> AACTAGATGCT
AAACTTCGACG -> AACTTCGACGA
AAAGATAGGAA -> AAGATAGGAAC
AAAGATCTGAC -> AAGATCTGACC
AAAGCAAGCAC -> AAGCAAGCACC
AAAGGCTTATA -> AAGGCTTATAT
AAAGGTGGGAC -> AAGGTGGGACT
AAAGTCAGTCC -> AAGTCAGTCCT
AAATAATTATG -> AATAATTATGA
AAATAGCACTC -> AATAGCACTCC
AAATCAACACA -> AATCAACACAA
AAATCTAGGTC -> AATCTAGGTCC
AAATCTGCGCA -> AATCTGCGCAT
AAATTATAAAA -> AATTATAAAAC
AAATTCTCGCG -> AATTCTCGCGG
AACAACACGTC -> ACAACACGTCA
AACAACGCAGC -> ACAACGCAGCA
AACAACGCCGT -> ACAACGCCGTT
AACAATGGTAA -> ACAATGGTAAC
AACAATTCCCG -> ACAATTCCCGA
AACACAAGCAG -> ACACAAGCAGG
AACACCGAACA -> ACACCGAACAC
AACACCGTGGT -> ACACCGTGGTT
AACACGTCAGT -> ACACGTCAGTC
AACAGAGGCCT -> ACAGAGGCCTC
AACAGCGACGT -> ACAGCGACGTG
AACATAATAGG -> ACATAATAGGT
AACATCACAGA -> ACATCACAGAT
AACATCCAGAT -> ACATCCAGATA
AACATGCCTAT -> ACATGCCTATC
AACCCTTGTCT -> ACCCTTGTCTA
AACCTGGGTTG -> ACCTGGGTTGG
AACGCACAAGG -> ACGCACAAGGT
AACGCAGCAAG -> ACGCAGCAAGT
AACGCCGTTCG -> ACGCCGTTCGG
AACGCGGACTT -> ACGCGGACTTC
AACGCGTAAAA -> ACGCGTAAAAA
AACGCTCGACG -> ACGCTCGACGG
AACGTATCTTA -> ACGTATCTTAC
AACTAGATGCT -> ACTAGATGCTA
AACTATTGGAC -> ACTATTGGACT
AACTCAATCGG -> ACTCAATCGGG
AACTCGCCTAA -> ACTCGCCTAAT
AACTTCGACGA -> ACTTCGACGAT
AAGAAAACCTG -> AGAAAACCTGG
AAGAAACATAA -> AGAAACATAAT
AAGAAAGATCT -> AGAAAGATCTG
AAGAAATTCTC -> AGAAATTCTCG
AAGAACCCGAG -> AGAACCCGAGC
AAGAATTCTGT -> AGAATTCTGTC
AAGACGTTTAC -> AGACGTTTACT
AAGACTTCACA -> AGACTTCACAT
AAGAGCCCTAG -> AGAGCCCTAGA
AAGAGCTGACG -> AGAGCTGACGA
AAGAGGCGGAA -> AGAGGCGGAAG
AAGATAACAAT -> AGATAACAATG
AAGATAGGAAC -> AGATAGGAACA
AAGATCGATAA -> AGATCGATAAG
AAGATCTGACC -> AGATCTGACCG
AAGCAAGCACC -> AGCAAGCACCC
AAGCACCCGGT -> AGCACCCGGTA
AAGCAGGGAGT -> AGCAGGGAGTG
AAGCAGTTCGA -> AGCAGTTCGAT
AAGCCACGGAC -> AGCCACGGACG
AAGCGATCCGG -> AGCGATCCGGA
AAGCGGCAGCA -> AGCGGCAGCAG
AAGCGGCCTCG -> AGCGGCCTCGA
AAGGCTGCTCC -> AGGCTGCTCCC
AAGGCTTATAT -> AGGCTTATATT
AAGGTCTATGT -> AGGTCTATGTC
AAGGTGGGACT -> AGGTGGGACTT
AAGGTTGTCCC -> AGGTTGTCCCT
AAGTCAGTCCT -> AGTCAGTCCTC
AAGTCCTTGGC -> AGTCCTTGGCG
AAGTCGCTCCC -> AGTCGCTCCCG
AAGTGAGGTTA -> AGTGAGGTTAG
AAGTGGCTTTG -> AGTGGCTTTGA
AATAACAGAGG -> ATAACAGAGGC
AATAATTATGA -> ATAATTATGAA
AATACAGACGT -> ATACAGACGTC
AATAGCACTCC -> ATAGCACTCCA
AATAGGTATAC -> ATAGGTATACC
AATAGGTGGGT -> ATAGGTGGGTT
AATATGGATCT -> ATATGGATCTG
AATATGTCATA -> ATATGTCATAG
AATCAACACAA -> ATCAACACAAG
AATCAGAGAAT -> ATCAGAGAATT
AATCGCTTTTA -> ATCGCTTTTAA
AATCGGGTGGC -> ATCGGGTGGCG
AATCTAGGTCC -> ATCTAGGTCCT
AATCTATCGCT -> ATCTATCGCTA
AATCTGCGCAT -> ATCTGCGCATA
AATGCTGCTGC -> ATGCTGCTGCG
AATGGAGGGTA -> ATGGAGGGTAG
AATGGTAACGT -> ATGGTAACGTA
AATGTCGCAAG -> ATGTCGCAAGC
AATTAACTATT -> ATTAACTATTG
AATTATAAAAC -> ATTATAAAACA
AATTATGAAGC -> ATTATGAAGCA
AATTCCCGAAA -> ATTCCCGAAAG
AATTCTCGCGG -> ATTCTCGCGGT
AATTCTGTCAT -> ATTCTGTCATC
AATTGCCGTTA -> ATTGCCGTTAA
AATTTTTAAAG -> ATTTTTAAAGC
ACAAATCTAGG -> CAAATCTAGGT
ACAACACGTCA -> CAACACGTCAG
ACAACGCAGCA -> CAACGCAGCAA
ACAACGCCGTT -> CAACGCCGTTC
ACAACGCTCGA -> CAACGCTCGAC
ACAAGAAACAT -> CAAGAAACATA
ACAAGAAATTC -> CAAGAAATTCT
ACAAGCAGGGA -> CAAGCAGGGAG
ACAAGGTTGTC -> CAAGGTTGTCC
ACAATATGGAT -> CAATATGGATC
ACAATGGTAAC -> CAATGGTAACG
ACAATTCCCGA -> CAATTCCCGAA
ACACAAGCAGG -> CACAAGCAGGG
ACACATCCTTG -> CACATCCTTGA
ACACCACCTGC -> CACCACCTGCG
ACACCGAAACA -> CACCGAAACAT
ACACCGAACAC -> CACCGAACACC
ACACCGTGGTT -> CACCGTGGTTT
ACACGGTTCCC -> CACGGTTCCCA
ACACGTCAGTC -> CACGTCAGTCG
ACAGAAACTAG -> CAGAAACTAGA
ACAGAAAGATA -> CAGAAAGATAG
ACAGAACGCAC -> CAGAACGCACA
ACAGACCCTGA -> CAGACCCTGAC
ACAGACGTCGA -> CAGACGTCGAC
ACAGAGGCCTC -> CAGAGGCCTCC
ACAGATACGTC -> CAGATACGTCA
ACAGATTCCCA -> CAGATTCCCAT
ACAGCGACGTG -> CAGCGACGTGC
ACAGCTTGTAT -> CAGCTTGTATC
ACAGTCGCCTT -> CAGTCGCCTTT
ACAGTCGGCTC -> CAGTCGGCTCA
ACAGTTGCATA -> CAGTTGCATAG
ACATAATAGGT -> CATAATAGGTG
ACATCACAGAT -> CATCACAGATA
ACATCACTGGA -> CATCACTGGAC
ACATCCAGATA -> CATCCAGATAC
ACATCCTTGAA -> CATCCTTGAAG
ACATGCCTATC -> CATGCCTATCG
ACATTGTGTAA -> CATTGTGTAAT
ACCACCTGCGC -> CCACCTGCGCT
ACCACGGAAGA -> CCACGGAAGAA
ACCAGGCTGTC -> CCAGGCTGTCA
ACCCCCAACTC -> CCCCCAACTCA
ACCCCGACACC -> CCCCGACACCG
ACCCGGTAGCG -> CCCGGTAGCGT
ACCCTGACCGC -> CCCTGACCGCC
ACCCTTGTCTA -> CCCTTGTCTAC
ACCGAAACATC -> CCGAAACATCC
ACCGAACACCG -> CCGAACACCGT
ACCGAATGCTG -> CCGAATGCTGC
ACCGCCGACCT -> CCGCCGACCTG
ACCGTATCAGT -> CCGTATCAGTA
ACCGTCTTGAG -> CCGTCTTGAGG
ACCGTGCGGCT -> CCGTGCGGCTT
ACCGTGGGAGT -> CCGTGGGAGTG
ACCGTGGTTTG -> CCGTGGTTTGC
ACCTACCGTGC -> CCTACCGTGCG
ACCTGCGCTTA -> CCTGCGCTTAA
ACCTGGCCTCA -> CCTGGCCTCAA
ACCTGGGTTGG -> CCTGGGTTGGC
ACCTGTGCTGC -> CCTGTGCTGCC
ACCTGTTCTTA -> CCTGTTCTTAT
ACCTTGCGGCA -> CCTTGCGGCAG
ACGAACGCGGA -> CGAACGCGGAC
ACGAATAACAG -> CGAATAACAGA
ACGAGCGAGAA -> CGAGCGAGAAA
ACGATACGCCC -> CGATACGCCCT
ACGCAAAACCC -> CGCAAAACCCT
ACGCAAATAAT -> CGCAAATAATT
ACGCACAAGGT -> CGCACAAGGTT
ACGCAGCAAGT -> CGCAGCAAGTG
ACGCCAATCGC -> CGCCAATCGCT
ACGCCAGGAGG -> CGCCAGGAGGC
ACGCCCTGAGT -> CGCCCTGAGTG
ACGCCGTTCGG -> CGCCGTTCGGT
ACGCGGACTTC -> CGCGGACTTCT
ACGCGTAAAAA -> CGCGTAAAAAT
ACGCTCGACGG -> CGCTCGACGGG
ACGGAACTCGC -> CGGAACTCGCC
ACGGAAGAAAG -> CGGAAGAAAGA
ACGGACGCCAG -> CGGACGCCAGG
ACGGGAGACTA -> CGGGAGACTAC
ACGGTGAAGAG -> CGGTGAAGAGC
ACGGTTCCCAC -> CGGTTCCCACT
ACGTAGGGACA -> CGTAGGGACAC
ACGTATATCCA -> CGTATATCCAG
ACGTATCTTAC -> CGTATCTTACG
ACGTCACAGTT -> CGTCACAGTTG
ACGTCAGTCGT -> CGTCAGTCGTG
ACGTCCCTGTT -> CGTCCCTGTTA
ACGTCGACTCG -> CGTCGACTCGC
ACGTCGAGGTC -> CGTCGAGGTCC
ACGTGCTCGAC -> CGTGCTCGACA
ACGTTTACTCC -> CGTTTACTCCG
ACTACATCACT -> CTACATCACTG
ACTACGTATAT -> CTACGTATATC
ACTACTACGTA -> CTACTACGTAT
ACTAGATGCTA -> CTAGATGCTAT
ACTATTGGACT -> CTATTGGACTG
ACTCAATCGGG -> CTCAATCGGGT
ACTCATTTCGG -> CTCATTTCGGT
ACTCCACGAAC -> CTCCACGAACG
ACTCCGAGGTT -> CTCCGAGGTTT
ACTCGCCTAAT -> CTCGCCTAATA
ACTCGCGGAGC -> CTCGCGGAGCC
ACTCTCAAATC -> CTCTCAAATCT
ACTCTTGCGGC -> CTCTTGCGGCC
ACTGGACCGAA -> CTGGACCGAAT
ACTGGCACAAT -> CTGGCACAATA
ACTGTCCATTG -> CTGTCCATTGG
ACTGTCGAGTG -> CTGTCGAGTGT
ACTGTTCAAGA -> CTGTTCAAGAT
ACTTCACATTG -> CTTCACATTGT
ACTTCGACGAT -> CTTCGACGATA
ACTTCTAGTTT -> CTTCTAGTTTG
ACTTTGAGCCT -> CTTTGAGCCTG
AGAAAACCTGG -> GAAAACCTGGG
AGAAACAACGC -> GAAACAACGCC
AGAAACATAAT -> GAAACATAATA
AGAAACTAGAT -> GAAACTAGATG
AGAAAGATAGG -> GAAAGATAGGA
AGAAAGATCTG -> GAAAGATCTGA
AGAAATTATAA -> GAAATTATAAA
AGAAATTCTCG -> GAAATTCTCGC
AGAACCCGAGC -> GAACCCGAGCT
AGAACGCACAA -> GAACGCACAAG
AGAAGCCACGG -> GAAGCCACGGA
AGAAGCGATCC -> GAAGCGATCCG
AGAATACAGAC -> GAATACAGACG
AGAATTCTGTC -> GAATTCTGTCA
AGAATTGCCGT -> GAATTGCCGTT
AGACAAGAAAT -> GACAAGAAATT
AGACAGTCGCC -> GACAGTCGCCT
AGACAGTCGGC -> GACAGTCGGCT
AGACCCTGACC -> GACCCTGACCG
AGACGTCGACT -> GACGTCGACTC
AGACGTCGAGG -> GACGTCGAGGT
AGACGTTTACT -> GACGTTTACTC
AGACTACATCA -> GACTACATCAC
AGACTTCACAT -> GACTTCACATT
AGAGAATTGCC -> GAGAATTGCCG
AGAGCCCTAGA -> GAGCCCTAGAA
AGAGCTGACGA -> GAGCTGACGAG
AGAGGCCTCCA -> GAGGCCTCCAA
AGAGGCGGAAG -> GAGGCGGAAGA
AGAGTTAAGAG -> GAGTTAAGAGG
AGATAACAATG -> GATAACAATGG
AGATACACCAC -> GATACACCACC
AGATACGTCAC -> GATACGTCACA
AGATAGGAACA -> GATAGGAACAT
AGATCATTTGC -> GATCATTTGCG
AGATCGATAAG -> GATCGATAAGG
AGATCTGACCG -> GATCTGACCGT
AGATGCTATAT -> GATGCTATATT
AGATTCCCATC -> GATTCCCATCG
AGCAAGCACCC -> GCAAGCACCCG
AGCAAGTGAGG -> GCAAGTGAGGT
AGCACCCGGTA -> GCACCCGGTAG
AGCACTCCACG -> GCACTCCACGA
AGCACTCTTGC -> GCACTCTTGCG
AGCAGGGAGTG -> GCAGGGAGTGA
AGCAGTCGGAT -> GCAGTCGGATG
AGCAGTTCGAT -> GCAGTTCGATC
AGCCACGGACG -> GCCACGGACGC
AGCCCCACGTA -> GCCCCACGTAG
AGCCCCAGGTT -> GCCCCAGGTTC
AGCCCTAGAAG -> GCCCTAGAAGC
AGCCTGTAGTC -> GCCTGTAGTCT
AGCGACGTGCT -> GCGACGTGCTC
AGCGAGAAATT -> GCGAGAAATTA
AGCGATCCGGA -> GCGATCCGGAT
AGCGCGATGTC -> GCGCGATGTCG
AGCGGCAGCAG -> GCGGCAGCAGT
AGCGGCCTCGA -> GCGGCCTCGAT
AGCGTTGGAGG -> GCGTTGGAGGC
AGCTGACGAGC -> GCTGACGAGCG
AGCTGCCGGAA -> GCTGCCGGAAT
AGCTTGTATCA -> GCTTGTATCAA
AGGAACATCAC -> GGAACATCACA
AGGAGGCTTAG -> GGAGGCTTAGA
AGGCATTTTCA -> GGCATTTTCAG
AGGCCCTCTCG -> GGCCCTCTCGG
AGGCCTACGCA -> GGCCTACGCAA
AGGCCTCCAAG -> GGCCTCCAAGA
AGGCGGAAGAT -> GGCGGAAGATA
AGGCTGCTCCC -> GGCTGCTCCCG
AGGCTGTCATA -> GGCTGTCATAT
AGGCTTAGACA -> GGCTTAGACAG
AGGCTTATATT -> GGCTTATATTC
AGGGACACATC -> GGGACACATCC
AGGGAGTGACA -> GGGAGTGACAG
AGGGCGGTACG -> GGGCGGTACGG
AGGGCTTCGCT -> GGGCTTCGCTA
AGGGGTTTGCG -> GGGGTTTGCGA
AGGGTAGGGTT -> GGGTAGGGTTA
AGGGTCGAAAC -> GGGTCGAAACT
AGGGTTAAGCG -> GGGTTAAGCGG
AGGTATACCAG -> GGTATACCAGG
AGGTCCTTGGG -> GGTCCTTGGGA
AGGTCCTTGGT -> GGTCCTTGGTA
AGGTCTATGTC -> GGTCTATGTCC
AGGTGGGACTT -> GGTGGGACTTT
AGGTGGGTTAC -> GGTGGGTTACA
AGGTTAGACAG -> GGTTAGACAGT
AGGTTCCCTCA -> GGTTCCCTCAC
AGGTTGTCCCT -> GGTTGTCCCTG
AGGTTTGGCGA -> GGTTTGGCGAC
AGGTTTTTCAT -> GGTTTTTCATA
AGTACAGAAAG -> GTACAGAAAGA
AGTCAGAATAC -> GTCAGAATACA
AGTCAGTCCTC -> GTCAGTCCTCC
AGTCCCTTAAT -> GTCCCTTAATG
AGTCCTCCCAT -> GTCCTCCCATA
AGTCCTTGGCG -> GTCCTTGGCGG
AGTCGCCTTTG -> GTCGCCTTTGT
AGTCGCTCCCG -> GTCGCTCCCGC
AGTCGGATGAG -> GTCGGATGAGG
AGTCGGCTCAC -> GTCGGCTCACG
AGTCGTGTGGT -> GTCGTGTGGTA
AGTCTGACCGT -> GTCTGACCGTA
AGTGACAGACC -> GTGACAGACCC
AGTGAGGTTAG -> GTGAGGTTAGA
AGTGAGTCAGA -> GTGAGTCAGAA
AGTGCAAGTGG -> GTGCAAGTGGC
AGTGCGGGACC -> GTGCGGGACCC
AGTGGATAGAC -> GTGGATAGACA
AGTGGCTTTGA -> GTGGCTTTGAA
AGTGTCTTCGG -> GTGTCTTCGGA
AGTTAAGAGGC -> GTTAAGAGGCG
AGTTCGATCTC -> GTTCGATCTCC
AGTTCTCGTGG -> GTTCTCGTGGA
AGTTCTGCTAA -> GTTCTGCTAAT
AGTTGCATAGG -> GTTGCATAGGG
AGTTGGAGAAA -> GTTGGAGAAAC
AGTTTGCTGGT -> GTTTGCTGGTT
ATAAAACAACG -> TAAAACAACGC
ATAACAATGGT -> TAACAATGGTA
ATAACAGAGGC -> TAACAGAGGCC
ATAAGGCTGCT -> TAAGGCTGCTC
ATAAGGTCTAT -> TAAGGTCTATG
ATAAGTCCTTG -> TAAGTCCTTGG
ATAATAGGTGG -> TAATAGGTGGG
ATAATTATGAA -> TAATTATGAAG
ATACACCACCT -> TACACCACCTG
ATACAGACGTC -> TACAGACGTCG
ATACAGCTTGT -> TACAGCTTGTA
ATACCAGGCTG -> TACCAGGCTGT
ATACCCCCAAC -> TACCCCCAACT
ATACGCCCTGA -> TACGCCCTGAG
ATACGTCACAG -> TACGTCACAGT
ATACTGTCGAG -> TACTGTCGAGT
ATAGACAAGAA -> TAGACAAGAAA
ATAGCACTCCA -> TAGCACTCCAC
ATAGCTGCCGG -> TAGCTGCCGGA
ATAGGAACATC -> TAGGAACATCA
ATAGGCATTTT -> TAGGCATTTTC
ATAGGGCTTCG -> TAGGGCTTCGC
ATAGGGGTTTG -> TAGGGGTTTGC
ATAGGTATACC -> TAGGTATACCA
ATAGGTGGGTT -> TAGGTGGGTTA
ATAGTGCAAGT -> TAGTGCAAGTG
ATAGTTGGAGA -> TAGTTGGAGAA
ATATAGGGCTT -> TATAGGGCTTC
ATATCCAGTGC -> TATCCAGTGCG
ATATGGATCTG -> TATGGATCTGT
ATATGGGTACC -> TATGGGTACCG
ATATGTCATAG -> TATGTCATAGC
ATATTCCCGGT -> TATTCCCGGTT
ATATTCGGTCG -> TATTCGGTCGA
ATCAAACGCGT -> TCAAACGCGTA
ATCAACACAAG -> TCAACACAAGC
ATCACAGATAC -> TCACAGATACG
ATCACTGGACC -> TCACTGGACCG
ATCAGAGAATT -> TCAGAGAATTG
ATCAGTACAGA -> TCAGTACAGAA
ATCATAAGTCC -> TCATAAGTCCT
ATCATTTGCGT -> TCATTTGCGTT
ATCCAGATACA -> TCCAGATACAC
ATCCAGTGCGG -> TCCAGTGCGGG
ATCCGGATACA -> TCCGGATACAG
ATCCTACCTAC -> TCCTACCTACC
ATCCTTGAAGA -> TCCTTGAAGAG
ATCGACGCAAA -> TCGACGCAAAT
ATCGATAAGGT -> TCGATAAGGTC
ATCGCTACTGT -> TCGCTACTGTT
ATCGCTTTTAA -> TCGCTTTTAAG
ATCGGGTGGCG -> TCGGGTGGCGG
ATCGGTCTCCA -> TCGGTCTCCAC
ATCTAGGTCCT -> TCTAGGTCCTT
ATCTATCGCTA -> TCTATCGCTAC
ATCTCCCGTAC -> TCTCCCGTACA
ATCTCGACTGG -> TCTCGACTGGC
ATCTGACCGTG -> TCTGACCGTGG
ATCTGCGCATA -> TCTGCGCATAC
ATCTGTAAAAG -> TCTGTAAAAGT
ATCTGTTGGGG -> TCTGTTGGGGT
ATCTTACGCCA -> TCTTACGCCAA
ATGAAGCAGTT -> TGAAGCAGTTC
ATGAGGGCGGT -> TGAGGGCGGTA
ATGCCATGGCC -> TGCCATGGCCA
ATGCCTATCGA -> TGCCTATCGAC
ATGCTATATTC -> TGCTATATTCG
ATGCTGCTGCG -> TGCTGCTGCGC
ATGGAGGGTAG -> TGGAGGGTAGG
ATGGATCTGTA -> TGGATCTGTAA
ATGGCCACTCA -> TGGCCACTCAT
ATGGGTACCGT -> TGGGTACCGTC
ATGGTAACGTA -> TGGTAACGTAT
ATGTCATAGCT -> TGTCATAGCTG
ATGTCCTCTGA -> TGTCCTCTGAT
ATGTCGCAAGC -> TGTCGCAAGCG
ATGTCGCGAGT -> TGTCGCGAGTT
ATTAACTATTG -> TTAACTATTGG
ATTATAAAACA -> TTATAAAACAA
ATTATGAAGCA -> TTATGAAGCAG
ATTCCCATCGG -> TTCCCATCGGT
ATTCCCGAAAG -> TTCCCGAAAGG
ATTCCCGGTTC -> TTCCCGGTTCA
ATTCCTAGCCC -> TTCCTAGCCCC
ATTCGGTCGAT -> TTCGGTCGATA
ATTCTCGCGGT -> TTCTCGCGGTT
ATTCTGTCATC -> TTCTGTCATCT
ATTGCATCATA -> TTGCATCATAA
ATTGCCGTTAA -> TTGCCGTTAAT
ATTGGACTGTC -> TTGGACTGTCC
ATTGGCTAGAT -> TTGGCTAGATC
ATTGTATTCCT -> TTGTATTCCTA
ATTGTGTAATG -> TTGTGTAATGG
ATTTCCTCTGC -> TTTCCTCTGCC
ATTTCGGTTAG -> TTTCGGTTAGA
ATTTGCGTTTG -> TTTGCGTTTGG
ATTTTCAGTTC -> TTTTCAGTTCT
ATTTTTAAAGC -> TTTTTAAAGCA
CAAAACCCTTG -> AAAACCCTTGT
CAAACGCGTAA -> AAACGCGTAAA
CAAATAATTAT -> AAATAATTATG
CAAATCTAGGT -> AAATCTAGGTC
CAAATCTGCGC -> AAATCTGCGCA
CAACACAAGCA -> AACACAAGCAG
CAACACGTCAG -> AACACGTCAGT
CAACGCAGCAA -> AACGCAGCAAG
CAACGCCGTTC -> AACGCCGTTCG
CAACGCTCGAC -> AACGCTCGACG
CAACTCAATCG -> AACTCAATCGG
CAAGAAAACCT -> AAGAAAACCTG
CAAGAAACATA -> AAGAAACATAA
CAAGAAATTCT -> AAGAAATTCTC
CAAGACTTCAC -> AAGACTTCACA
CAAGATCGATA -> AAGATCGATAA
CAAGCACCCGG -> AAGCACCCGGT
CAAGCAGGGAG -> AAGCAGGGAGT
CAAGCGGCCTC -> AAGCGGCCTCG
CAAGGTTGTCC -> AAGGTTGTCCC
CAAGTCGCTCC -> AAGTCGCTCCC
CAAGTGAGGTT -> AAGTGAGGTTA
CAAGTGGCTTT -> AAGTGGCTTTG
CAATATGGATC -> AATATGGATCT
CAATCGCTTTT -> AATCGCTTTTA
CAATCGGGTGG -> AATCGGGTGGC
CAATGGTAACG -> AATGGTAACGT
CAATTAACTAT -> AATTAACTATT
CAATTCCCGAA -> AATTCCCGAAA
CACAAGAAACA -> ACAAGAAACAT
CACAAGCAGGG -> ACAAGCAGGGA
CACAAGGTTGT -> ACAAGGTTGTC
CACAATATGGA -> ACAATATGGAT
CACAGATACGT -> ACAGATACGTC
CACAGTTGCAT -> ACAGTTGCATA
CACATCCTTGA -> ACATCCTTGAA
CACATTGTGTA -> ACATTGTGTAA
CACCACCTGCG -> ACCACCTGCGC
CACCCGGTAGC -> ACCCGGTAGCG
CACCGAAACAT -> ACCGAAACATC
CACCGAACACC -> ACCGAACACCG
CACCGTGGTTT -> ACCGTGGTTTG
CACCTGCGCTT -> ACCTGCGCTTA
CACCTGGCCTC -> ACCTGGCCTCA
CACCTGTTCTT -> ACCTGTTCTTA
CACCTTGCGGC -> ACCTTGCGGCA
CACGAACGCGG -> ACGAACGCGGA
CACGGAACTCG -> ACGGAACTCGC
CACGGAAGAAA -> ACGGAAGAAAG
CACGGACGCCA -> ACGGACGCCAG
CACGGTTCCCA -> ACGGTTCCCAC
CACGTAGGGAC -> ACGTAGGGACA
CACGTCAGTCG -> ACGTCAGTCGT
CACGTCCCTGT -> ACGTCCCTGTT
CACTCATTTCG -> ACTCATTTCGG
CACTCCACGAA -> ACTCCACGAAC
CACTCTCAAAT -> ACTCTCAAATC
CACTCTTGCGG -> ACTCTTGCGGC
CACTGGACCGA -> ACTGGACCGAA
CAGAAACTAGA -> AGAAACTAGAT
CAGAAAGATAG -> AGAAAGATAGG
CAGAACGCACA -> AGAACGCACAA
CAGAATACAGA -> AGAATACAGAC
CAGACCCTGAC -> AGACCCTGACC
CAGACGTCGAC -> AGACGTCGACT
CAGAGAATTGC -> AGAGAATTGCC
CAGAGGCCTCC -> AGAGGCCTCCA
CAGATACACCA -> AGATACACCAC
CAGATACGTCA -> AGATACGTCAC
CAGATTCCCAT -> AGATTCCCATC
CAGCAAGTGAG -> AGCAAGTGAGG
CAGCACTCTTG -> AGCACTCTTGC
CAGCAGTCGGA -> AGCAGTCGGAT
CAGCGACGTGC -> AGCGACGTGCT
CAGCTTGTATC -> AGCTTGTATCA
CAGGAGGCTTA -> AGGAGGCTTAG
CAGGCCTACGC -> AGGCCTACGCA
CAGGCTGTCAT -> AGGCTGTCATA
CAGGGAGTGAC -> AGGGAGTGACA
CAGGGTCGAAA -> AGGGTCGAAAC
CAGGTTCCCTC -> AGGTTCCCTCA
CAGTACAGAAA -> AGTACAGAAAG
CAGTCCCTTAA -> AGTCCCTTAAT
CAGTCCTCCCA -> AGTCCTCCCAT
CAGTCGCCTTT -> AGTCGCCTTTG
CAGTCGGATGA -> AGTCGGATGAG
CAGTCGGCTCA -> AGTCGGCTCAC
CAGTCGTGTGG -> AGTCGTGTGGT
CAGTGCGGGAC -> AGTGCGGGACC
CAGTTCGATCT -> AGTTCGATCTC
CAGTTCTGCTA -> AGTTCTGCTAA
CAGTTGCATAG -> AGTTGCATAGG
CATAAGGCTGC -> ATAAGGCTGCT
CATAAGTCCTT -> ATAAGTCCTTG
CATAATAGGTG -> ATAATAGGTGG
CATACCCCCAA -> ATACCCCCAAC
CATACTGTCGA -> ATACTGTCGAG
CATAGCTGCCG -> ATAGCTGCCGG
CATAGGGGTTT -> ATAGGGGTTTG
CATAGTTGGAG -> ATAGTTGGAGA
CATATAGGGCT -> ATATAGGGCTT
CATCACAGATA -> ATCACAGATAC
CATCACTGGAC -> ATCACTGGACC
CATCATAAGTC -> ATCATAAGTCC
CATCCAGATAC -> ATCCAGATACA
CATCCTTGAAG -> ATCCTTGAAGA
CATCGGTCTCC -> ATCGGTCTCCA
CATCTCGACTG -> ATCTCGACTGG
CATGCCTATCG -> ATGCCTATCGA
CATGGCCACTC -> ATGGCCACTCA
CATTGCATCAT -> ATTGCATCATA
CATTGGCTAGA -> ATTGGCTAGAT
CATTGTGTAAT -> ATTGTGTAATG
CATTTCGGTTA -> ATTTCGGTTAG
CATTTGCGTTT -> ATTTGCGTTTG
CATTTTCAGTT -> ATTTTCAGTTC
CCAACTCAATC -> CAACTCAATCG
CCAAGAAAACC -> CAAGAAAACCT
CCAAGACTTCA -> CAAGACTTCAC
CCAATCGCTTT -> CAATCGCTTTT
CCACAAGAAAC -> CACAAGAAACA
CCACCTGCGCT -> CACCTGCGCTT
CCACGAACGCG -> CACGAACGCGG
CCACGGAAGAA -> CACGGAAGAAA
CCACGGACGCC -> CACGGACGCCA
CCACGTAGGGA -> CACGTAGGGAC
CCACTCATTTC -> CACTCATTTCG
CCACTCTCAAA -> CACTCTCAAAT
CCAGATACACC -> CAGATACACCA
CCAGCACTCTT -> CAGCACTCTTG
CCAGGAGGCTT -> CAGGAGGCTTA
CCAGGCTGTCA -> CAGGCTGTCAT
CCAGGTTCCCT -> CAGGTTCCCTC
CCAGTGCGGGA -> CAGTGCGGGAC
CCATACCCCCA -> CATACCCCCAA
CCATCGGTCTC -> CATCGGTCTCC
CCATGGCCACT -> CATGGCCACTC
CCATTGCATCA -> CATTGCATCAT
CCATTGGCTAG -> CATTGGCTAGA
CCCAACTCAAT -> CCAACTCAATC
CCCACGTAGGG -> CCACGTAGGGA
CCCACTCTCAA -> CCACTCTCAAA
CCCAGGTTCCC -> CCAGGTTCCCT
CCCATACCCCC -> CCATACCCCCA
CCCATCGGTCT -> CCATCGGTCTC
CCCCAACTCAA -> CCCAACTCAAT
CCCCACGTAGG -> CCCACGTAGGG
CCCCAGGTTCC -> CCCAGGTTCCC
CCCCCAACTCA -> CCCCAACTCAA
CCCCGACACCG -> CCCGACACCGA
CCCGAAAGGCT -> CCGAAAGGCTT
CCCGACACCGA -> CCGACACCGAA
CCCGCAGTCCC -> CCGCAGTCCCT
CCCGCTGGCAC -> CCGCTGGCACC
CCCGGTAGCGT -> CCGGTAGCGTT
CCCGGTTCATA -> CCGGTTCATAG
CCCGTACAGAT -> CCGTACAGATT
CCCTAGAAGCG -> CCTAGAAGCGA
CCCTCACGGAA -> CCTCACGGAAC
CCCTCTCGGAG -> CCTCTCGGAGA
CCCTGACCGCC -> CCTGACCGCCG
CCCTGAGTGAG -> CCTGAGTGAGT
CCCTGATCCTA -> CCTGATCCTAC
CCCTGTTACCA -> CCTGTTACCAC
CCCTTAATGTC -> CCTTAATGTCG
CCCTTGTCTAC -> CCTTGTCTACA
CCGAAAATCAA -> CGAAAATCAAC
CCGAAACATCC -> CGAAACATCCA
CCGAAAGGCTT -> CGAAAGGCTTA
CCGAACACCGT -> CGAACACCGTG
CCGAATGCTGC -> CGAATGCTGCT
CCGACACCGAA -> CGACACCGAAA
CCGACCTGTGC -> CGACCTGTGCT
CCGAGGTTTTT -> CGAGGTTTTTC
CCGCAGTCCCT -> CGCAGTCCCTT
CCGCCGAAAAT -> CGCCGAAAATC
CCGCCGACCTG -> CGCCGACCTGT
CCGCGCAGGCC -> CGCGCAGGCCT
CCGCTGGCACC -> CGCTGGCACCT
CCGGAATCAGA -> CGGAATCAGAG
CCGGATACAGC -> CGGATACAGCT
CCGGTAGCGTT -> CGGTAGCGTTG
CCGGTTCATAG -> CGGTTCATAGT
CCGTACAGATT -> CGTACAGATTC
CCGTATCAGTA -> CGTATCAGTAC
CCGTCTCGTGT -> CGTCTCGTGTG
CCGTCTTGAGG -> CGTCTTGAGGT
CCGTGCGGCTT -> CGTGCGGCTTT
CCGTGGGAGTG -> CGTGGGAGTGG
CCGTGGTTTGC -> CGTGGTTTGCC
CCGTTAATAGG -> CGTTAATAGGT
CCGTTCGGTGT -> CGTTCGGTGTG
CCTAATATGTC -> CTAATATGTCA
CCTACCGTGCG -> CTACCGTGCGG
CCTACCTACCG -> CTACCTACCGT
CCTACGCAAAA -> CTACGCAAAAC
CCTAGAAGCGA -> CTAGAAGCGAT
CCTAGCCCCAC -> CTAGCCCCACG
CCTATCGACGC -> CTATCGACGCA
CCTCAAGTCGC -> CTCAAGTCGCT
CCTCACGGAAC -> CTCACGGAACT
CCTCCAAGAAA -> CTCCAAGAAAA
CCTCCCATACC -> CTCCCATACCC
CCTCGATTTCC -> CTCGATTTCCT
CCTCTCGGAGA -> CTCTCGGAGAA
CCTCTGATATG -> CTCTGATATGG
CCTCTGCCAAG -> CTCTGCCAAGA
CCTGACCGCCG -> CTGACCGCCGA
CCTGAGTGAGT -> CTGAGTGAGTC
CCTGATCCTAC -> CTGATCCTACC
CCTGCGCTTAA -> CTGCGCTTAAT
CCTGGCCTCAA -> CTGGCCTCAAG
CCTGGGTTGGC -> CTGGGTTGGCA
CCTGTAGTCTG -> CTGTAGTCTGA
CCTGTGCTGCC -> CTGTGCTGCCA
CCTGTTACCAC -> CTGTTACCACG
CCTGTTCTTAT -> CTGTTCTTATC
CCTTAATGTCG -> CTTAATGTCGC
CCTTGAAGAGC -> CTTGAAGAGCT
CCTTGCGGCAG -> CTTGCGGCAGG
CCTTGGCGGGT -> CTTGGCGGGTG
CCTTGGGACAC -> CTTGGGACACG
CCTTGGTATTG -> CTTGGTATTGT
CCTTGTCTACA -> CTTGTCTACAG
CCTTTGTTGTA -> CTTTGTTGTAA
CGAAAATCAAC -> GAAAATCAACA
CGAAACATCCA -> GAAACATCCAG
CGAAACTTCGA -> GAAACTTCGAC
CGAAAGGCTTA -> GAAAGGCTTAT
CGAACACCGTG -> GAACACCGTGG
CGAACGCGGAC -> GAACGCGGACT
CGAATAACAGA -> GAATAACAGAG
CGAATGCTGCT -> GAATGCTGCTG
CGACAACGCTC -> GACAACGCTCG
CGACACCGAAA -> GACACCGAAAC
CGACCTGTGCT -> GACCTGTGCTG
CGACGATACGC -> GACGATACGCC
CGACGCAAATA -> GACGCAAATAA
CGACGGGAGAC -> GACGGGAGACT
CGACGTGCTCG -> GACGTGCTCGA
CGACTACTACG -> GACTACTACGT
CGACTCGCGGA -> GACTCGCGGAG
CGACTGGCACA -> GACTGGCACAA
CGAGAAATTAT -> GAGAAATTATA
CGAGCGAGAAA -> GAGCGAGAAAT
CGAGGTCCTTG -> GAGGTCCTTGG
CGAGGTTTTTC -> GAGGTTTTTCA
CGAGTGTCTTC -> GAGTGTCTTCG
CGAGTTCTCGT -> GAGTTCTCGTG
CGATAAGGTCT -> GATAAGGTCTA
CGATACGCCCT -> GATACGCCCTG
CGATAGTGCAA -> GATAGTGCAAG
CGATCCGGATA -> GATCCGGATAC
CGATCTCCCGT -> GATCTCCCGTA
CGATGCCATGG -> GATGCCATGGC
CGATGTCGCGA -> GATGTCGCGAG
CGATTTCCTCT -> GATTTCCTCTG
CGCAAAACCCT -> GCAAAACCCTT
CGCAAATAATT -> GCAAATAATTA
CGCAAGCGGCC -> GCAAGCGGCCT
CGCACAAGGTT -> GCACAAGGTTG
CGCAGCAAGTG -> GCAGCAAGTGA
CGCAGGCCTAC -> GCAGGCCTACG
CGCAGTCCCTT -> GCAGTCCCTTA
CGCATACTGTC -> GCATACTGTCG
CGCCAATCGCT -> GCCAATCGCTT
CGCCAGGAGGC -> GCCAGGAGGCT
CGCCCTGAGTG -> GCCCTGAGTGA
CGCCGAAAATC -> GCCGAAAATCA
CGCCGACCTGT -> GCCGACCTGTG
CGCCGTTCGGT -> GCCGTTCGGTG
CGCCTAATATG -> GCCTAATATGT
CGCCTTTGTTG -> GCCTTTGTTGT
CGCGAGTTCTC -> GCGAGTTCTCG
CGCGATGTCGC -> GCGATGTCGCG
CGCGCAGGCCT -> GCGCAGGCCTA
CGCGCTAACAA -> GCGCTAACAAC
CGCGGACTTCT -> GCGGACTTCTA
CGCGGAGCCCC -> GCGGAGCCCCA
CGCGGTTGCAC -> GCGGTTGCACC
CGCGTAAAAAT -> GCGTAAAAATA
CGCTAAAGGTG -> GCTAAAGGTGG
CGCTAACAACA -> GCTAACAACAC
CGCTACTGTTC -> GCTACTGTTCA
CGCTCCCGCAG -> GCTCCCGCAGT
CGCTCGACGGG -> GCTCGACGGGA
CGCTGGCACCT -> GCTGGCACCTG
CGCTTAATTTT -> GCTTAATTTTT
CGCTTTTAAGA -> GCTTTTAAGAA
CGGAACTCGCC -> GGAACTCGCCT
CGGAAGAAAGA -> GGAAGAAAGAT
CGGAAGATAAC -> GGAAGATAACA
CGGAATCAGAG -> GGAATCAGAGA
CGGACAGAACG -> GGACAGAACGC
CGGACGAATAA -> GGACGAATAAC
CGGACGCCAGG -> GGACGCCAGGA
CGGACTTCTAG -> GGACTTCTAGT
CGGAGAAGCCA -> GGAGAAGCCAC
CGGAGCCCCAG -> GGAGCCCCAGG
CGGATACAGCT -> GGATACAGCTT
CGGATGAGGGC -> GGATGAGGGCG
CGGCAGCAGTC -> GGCAGCAGTCG
CGGCAGGGTCG -> GGCAGGGTCGA
CGGCCGCGCAG -> GGCCGCGCAGG
CGGCCTCGATT -> GGCCTCGATTT
CGGCTCACGTC -> GGCTCACGTCC
CGGCTTTCACC -> GGCTTTCACCT
CGGGACCCCGA -> GGGACCCCGAC
CGGGAGACTAC -> GGGAGACTACA
CGGGGGGGGCT -> GGGGGGGGCTC
CGGGTGCGGAC -> GGGTGCGGACG
CGGGTGGCGGG -> GGGTGGCGGGG
CGGTACGGTGA -> GGTACGGTGAA
CGGTAGCGTTG -> GGTAGCGTTGG
CGGTCGATAGT -> GGTCGATAGTG
CGGTCTCCACA -> GGTCTCCACAA
CGGTGAAGAGC -> GGTGAAGAGCC
CGGTGTGGTGA -> GGTGTGGTGAG
CGGTTAGAGTT -> GGTTAGAGTTA
CGGTTCATAGT -> GGTTCATAGTT
CGGTTCCCACT -> GGTTCCCACTC
CGGTTGCACCT -> GGTTGCACCTG
CGTAAAAATAG -> GTAAAAATAGC
CGTACAGATTC -> GTACAGATTCC
CGTAGGGACAC -> GTAGGGACACA
CGTATATCCAG -> GTATATCCAGT
CGTATCAGTAC -> GTATCAGTACA
CGTATCTTACG -> GTATCTTACGC
CGTCACAGTTG -> GTCACAGTTGC
CGTCAGTCGTG -> GTCAGTCGTGT
CGTCCCTGTTA -> GTCCCTGTTAC
CGTCGACTCGC -> GTCGACTCGCG
CGTCGAGGTCC -> GTCGAGGTCCT
CGTCTCGTGTG -> GTCTCGTGTGG
CGTCTTGAGGT -> GTCTTGAGGTT
CGTGCGGCTTT -> GTGCGGCTTTC
CGTGCTCGACA -> GTGCTCGACAA
CGTGGATAGGC -> GTGGATAGGCA
CGTGGGAGTGG -> GTGGGAGTGGA
CGTGGTTTGCC -> GTGGTTTGCCG
CGTGTGGCCGC -> GTGTGGCCGCC
CGTGTGGTAAA -> GTGTGGTAAAC
CGTTAATAGGT -> GTTAATAGGTA
CGTTCGGTGTG -> GTTCGGTGTGG
CGTTGGAGGCC -> GTTGGAGGCCC
CGTTTACTCCG -> GTTTACTCCGA
CGTTTGGAACA -> GTTTGGAACAT
CTAAAGGTGGG -> TAAAGGTGGGA
CTAACAACACG -> TAACAACACGT
CTAATATGTCA -> TAATATGTCAT
CTAATCTATCG -> TAATCTATCGC
CTACAGAAACT -> TACAGAAACTA
CTACATCACTG -> TACATCACTGG
CTACCGTGCGG -> TACCGTGCGGC
CTACCTACCGT -> TACCTACCGTG
CTACGCAAAAC -> TACGCAAAACC
CTACGTATATC -> TACGTATATCC
CTACTACGTAT -> TACTACGTATA
CTACTGTTCAA -> TACTGTTCAAG
CTAGAAGCGAT -> TAGAAGCGATC
CTAGATCATTT -> TAGATCATTTG
CTAGATGCTAT -> TAGATGCTATA
CTAGCCCCACG -> TAGCCCCACGT
CTAGGTCCTTG -> TAGGTCCTTGG
CTAGTTTGCTG -> TAGTTTGCTGG
CTATATTCGGT -> TATATTCGGTC
CTATCGACGCA -> TATCGACGCAA
CTATCGCTACT -> TATCGCTACTG
CTATGTCCTCT -> TATGTCCTCTG
CTATTGGACTG -> TATTGGACTGT
CTCAAATCTGC -> TCAAATCTGCG
CTCAAGTCGCT -> TCAAGTCGCTC
CTCAATCGGGT -> TCAATCGGGTG
CTCACGGAACT -> TCACGGAACTC
CTCACGTCCCT -> TCACGTCCCTG
CTCATTTCGGT -> TCATTTCGGTT
CTCCAAGAAAA -> TCCAAGAAAAC
CTCCACAAGAA -> TCCACAAGAAA
CTCCACGAACG -> TCCACGAACGC
CTCCATTGCAT -> TCCATTGCATC
CTCCCATACCC -> TCCCATACCCC
CTCCCGCAGTC -> TCCCGCAGTCC
CTCCCGCTGGC -> TCCCGCTGGCA
CTCCCGTACAG -> TCCCGTACAGA
CTCCGAGGTTT -> TCCGAGGTTTT
CTCGACAACGC -> TCGACAACGCT
CTCGACGGGAG -> TCGACGGGAGA
CTCGACTGGCA -> TCGACTGGCAC
CTCGATTTCCT -> TCGATTTCCTC
CTCGCCTAATA -> TCGCCTAATAT
CTCGCGGAGCC -> TCGCGGAGCCC
CTCGCGGTTGC -> TCGCGGTTGCA
CTCGGAGAAGC -> TCGGAGAAGCC
CTCGTGGATAG -> TCGTGGATAGG
CTCGTGTGGCC -> TCGTGTGGCCG
CTCTCAAATCT -> TCTCAAATCTG
CTCTCGGAGAA -> TCTCGGAGAAG
CTCTGATATGG -> TCTGATATGGG
CTCTGCCAAGA -> TCTGCCAAGAC
CTCTTGCGGCC -> TCTTGCGGCCG
CTGACCGCCGA -> TGACCGCCGAC
CTGACCGTATC -> TGACCGTATCA
CTGACCGTGGG -> TGACCGTGGGA
CTGACGAGCGA -> TGACGAGCGAG
CTGAGTGAGTC -> TGAGTGAGTCA
CTGATATGGGT -> TGATATGGGTA
CTGATCCTACC -> TGATCCTACCT
CTGCCAAGACT -> TGCCAAGACTT
CTGCCAGCACT -> TGCCAGCACTC
CTGCCGGAATC -> TGCCGGAATCA
CTGCGCATACT -> TGCGCATACTG
CTGCGCGCTAA -> TGCGCGCTAAC
CTGCGCTTAAT -> TGCGCTTAATT
CTGCTAATCTA -> TGCTAATCTAT
CTGCTCCCGCT -> TGCTCCCGCTG
CTGCTGCGCGC -> TGCTGCGCGCT
CTGGACCGAAT -> TGGACCGAATG
CTGGCACAATA -> TGGCACAATAT
CTGGCACCTGG -> TGGCACCTGGC
CTGGCCTCAAG -> TGGCCTCAAGT
CTGGGTTGGCA -> TGGGTTGGCAA
CTGGTTTGAGC -> TGGTTTGAGCG
CTGTAAAAGTC -> TGTAAAAGTCA
CTGTAGTCTGA -> TGTAGTCTGAC
CTGTCATATAG -> TGTCATATAGG
CTGTCATCTCG -> TGTCATCTCGA
CTGTCCATTGG -> TGTCCATTGGC
CTGTCGAGTGT -> TGTCGAGTGTC
CTGTGCTGCCA -> TGTGCTGCCAG
CTGTTACCACG -> TGTTACCACGG
CTGTTCAAGAT -> TGTTCAAGATC
CTGTTCTTATC -> TGTTCTTATCT
CTGTTGGGGTA -> TGTTGGGGTAA
CTTAATGTCGC -> TTAATGTCGCA
CTTAATTTTTA -> TTAATTTTTAA
CTTACGCCAAT -> TTACGCCAATC
CTTAGACAGTC -> TTAGACAGTCG
CTTATATTCCC -> TTATATTCCCG
CTTATCTGTTG -> TTATCTGTTGG
CTTCACATTGT -> TTCACATTGTG
CTTCGACGATA -> TTCGACGATAC
CTTCGCTAAAG -> TTCGCTAAAGG
CTTCGGACAGA -> TTCGGACAGAA
CTTCTAGTTTG -> TTCTAGTTTGC
CTTGAAGAGCT -> TTGAAGAGCTG
CTTGAGGTTTG -> TTGAGGTTTGG
CTTGCGGCAGG -> TTGCGGCAGGG
CTTGCGGCCGC -> TTGCGGCCGCG
CTTGGCGGGTG -> TTGGCGGGTGC
CTTGGGACACG -> TTGGGACACGG
CTTGGTATTGT -> TTGGTATTGTA
CTTGTATCAAA -> TTGTATCAAAC
CTTGTCTACAG -> TTGTCTACAGA
CTTTCACCTTG -> TTTCACCTTGC
CTTTGAAACAG -> TTTGAAACAGC
CTTTGAGCCTG -> TTTGAGCCTGT
CTTTGTTGTAA -> TTTGTTGTAAG
CTTTTAAGAAC -> TTTTAAGAACC
GAAAACCTGGG -> AAAACCTGGGT
GAAAATCAACA -> AAAATCAACAC
GAAACAACGCC -> AAACAACGCCG
GAAACAGCGAC -> AAACAGCGACG
GAAACATAATA -> AAACATAATAG
GAAACATCCAG -> AAACATCCAGA
GAAACTAGATG -> AAACTAGATGC
GAAACTTCGAC -> AAACTTCGACG
GAAAGATAGGA -> AAAGATAGGAA
GAAAGATCTGA -> AAAGATCTGAC
GAAAGGCTTAT -> AAAGGCTTATA
GAAATTATAAA -> AAATTATAAAA
GAAATTCTCGC -> AAATTCTCGCG
GAACACCGTGG -> AACACCGTGGT
GAACATCACAG -> AACATCACAGA
GAACATGCCTA -> AACATGCCTAT
GAACCCGAGCT -> AACCCGAGCTC
GAACGCACAAG -> AACGCACAAGG
GAACGCGGACT -> AACGCGGACTT
GAACTCGCCTA -> AACTCGCCTAA
GAAGAAAGATC -> AAGAAAGATCT
GAAGAGCCCTA -> AAGAGCCCTAG
GAAGAGCTGAC -> AAGAGCTGACG
GAAGATAACAA -> AAGATAACAAT
GAAGCAGTTCG -> AAGCAGTTCGA
GAAGCCACGGA -> AAGCCACGGAC
GAAGCGATCCG -> AAGCGATCCGG
GAATAACAGAG -> AATAACAGAGG
GAATACAGACG -> AATACAGACGT
GAATCAGAGAA -> AATCAGAGAAT
GAATGCTGCTG -> AATGCTGCTGC
GAATTCTGTCA -> AATTCTGTCAT
GAATTGCCGTT -> AATTGCCGTTA
GACAACGCTCG -> ACAACGCTCGA
GACAAGAAATT -> ACAAGAAATTC
GACACATCCTT -> ACACATCCTTG
GACACCGAAAC -> ACACCGAAACA
GACACGGTTCC -> ACACGGTTCCC
GACAGAACGCA -> ACAGAACGCAC
GACAGACCCTG -> ACAGACCCTGA
GACAGTCGCCT -> ACAGTCGCCTT
GACAGTCGGCT -> ACAGTCGGCTC
GACCCCGACAC -> ACCCCGACACC
GACCCTGACCG -> ACCCTGACCGC
GACCGAATGCT -> ACCGAATGCTG
GACCGCCGACC -> ACCGCCGACCT
GACCGTATCAG -> ACCGTATCAGT
GACCGTGGGAG -> ACCGTGGGAGT
GACCTGTGCTG -> ACCTGTGCTGC
GACGAATAACA -> ACGAATAACAG
GACGAGCGAGA -> ACGAGCGAGAA
GACGATACGCC -> ACGATACGCCC
GACGCAAATAA -> ACGCAAATAAT
GACGCCAGGAG -> ACGCCAGGAGG
GACGGGAGACT -> ACGGGAGACTA
GACGTCGACTC -> ACGTCGACTCG
GACGTCGAGGT -> ACGTCGAGGTC
GACGTGCTCGA -> ACGTGCTCGAC
GACGTTTACTC -> ACGTTTACTCC
GACTACATCAC -> ACTACATCACT
GACTACTACGT -> ACTACTACGTA
GACTCGCGGAG -> ACTCGCGGAGC
GACTGGCACAA -> ACTGGCACAAT
GACTGTCCATT -> ACTGTCCATTG
GACTTCACATT -> ACTTCACATTG
GACTTCTAGTT -> ACTTCTAGTTT
GACTTTGAGCC -> ACTTTGAGCCT
GAGAAACAACG -> AGAAACAACGC
GAGAAATTATA -> AGAAATTATAA
GAGAAGCCACG -> AGAAGCCACGG
GAGAATTGCCG -> AGAATTGCCGT
GAGACGTCGAG -> AGACGTCGAGG
GAGACTACATC -> AGACTACATCA
GAGCCCCAGGT -> AGCCCCAGGTT
GAGCCCTAGAA -> AGCCCTAGAAG
GAGCCTGTAGT -> AGCCTGTAGTC
GAGCGAGAAAT -> AGCGAGAAATT
GAGCGCGATGT -> AGCGCGATGTC
GAGCTGACGAG -> AGCTGACGAGC
GAGGCCCTCTC -> AGGCCCTCTCG
GAGGCCTCCAA -> AGGCCTCCAAG
GAGGCGGAAGA -> AGGCGGAAGAT
GAGGCTTAGAC -> AGGCTTAGACA
GAGGGCGGTAC -> AGGGCGGTACG
GAGGGTAGGGT -> AGGGTAGGGTT
GAGGTCCTTGG -> AGGTCCTTGGG
GAGGTTAGACA -> AGGTTAGACAG
GAGGTTTGGCG -> AGGTTTGGCGA
GAGGTTTTTCA -> AGGTTTTTCAT
GAGTCAGAATA -> AGTCAGAATAC
GAGTGACAGAC -> AGTGACAGACC
GAGTGAGTCAG -> AGTGAGTCAGA
GAGTGGATAGA -> AGTGGATAGAC
GAGTGTCTTCG -> AGTGTCTTCGG
GAGTTAAGAGG -> AGTTAAGAGGC
GAGTTCTCGTG -> AGTTCTCGTGG
GATAACAATGG -> ATAACAATGGT
GATAAGGTCTA -> ATAAGGTCTAT
GATACACCACC -> ATACACCACCT
GATACAGCTTG -> ATACAGCTTGT
GATACGCCCTG -> ATACGCCCTGA
GATACGTCACA -> ATACGTCACAG
GATAGACAAGA -> ATAGACAAGAA
GATAGGAACAT -> ATAGGAACATC
GATAGGCATTT -> ATAGGCATTTT
GATAGTGCAAG -> ATAGTGCAAGT
GATATGGGTAC -> ATATGGGTACC
GATCATTTGCG -> ATCATTTGCGT
GATCCGGATAC -> ATCCGGATACA
GATCCTACCTA -> ATCCTACCTAC
GATCGATAAGG -> ATCGATAAGGT
GATCTCCCGTA -> ATCTCCCGTAC
GATCTGACCGT -> ATCTGACCGTG
GATCTGTAAAA -> ATCTGTAAAAG
GATGAGGGCGG -> ATGAGGGCGGT
GATGCCATGGC -> ATGCCATGGCC
GATGCTATATT -> ATGCTATATTC
GATGTCGCGAG -> ATGTCGCGAGT
GATTCCCATCG -> ATTCCCATCGG
GATTTCCTCTG -> ATTTCCTCTGC
GCAAAACCCTT -> CAAAACCCTTG
GCAAATAATTA -> CAAATAATTAT
GCAAGCACCCG -> CAAGCACCCGG
GCAAGCGGCCT -> CAAGCGGCCTC
GCAAGTGAGGT -> CAAGTGAGGTT
GCAAGTGGCTT -> CAAGTGGCTTT
GCAATTAACTA -> CAATTAACTAT
GCACAAGGTTG -> CACAAGGTTGT
GCACAATATGG -> CACAATATGGA
GCACCCGGTAG -> CACCCGGTAGC
GCACCTGGCCT -> CACCTGGCCTC
GCACCTGTTCT -> CACCTGTTCTT
GCACTCCACGA -> CACTCCACGAA
GCACTCTTGCG -> CACTCTTGCGG
GCAGCAAGTGA -> CAGCAAGTGAG
GCAGCAGTCGG -> CAGCAGTCGGA
GCAGGCCTACG -> CAGGCCTACGC
GCAGGGAGTGA -> CAGGGAGTGAC
GCAGGGTCGAA -> CAGGGTCGAAA
GCAGTCCCTTA -> CAGTCCCTTAA
GCAGTCGGATG -> CAGTCGGATGA
GCAGTTCGATC -> CAGTTCGATCT
GCATACTGTCG -> CATACTGTCGA
GCATAGGGGTT -> CATAGGGGTTT
GCATCATAAGT -> CATCATAAGTC
GCATTTTCAGT -> CATTTTCAGTT
GCCAAGACTTC -> CCAAGACTTCA
GCCAATCGCTT -> CCAATCGCTTT
GCCACGGACGC -> CCACGGACGCC
GCCACTCATTT -> CCACTCATTTC
GCCAGCACTCT -> CCAGCACTCTT
GCCAGGAGGCT -> CCAGGAGGCTT
GCCATGGCCAC -> CCATGGCCACT
GCCCCACGTAG -> CCCCACGTAGG
GCCCCAGGTTC -> CCCCAGGTTCC
GCCCTAGAAGC -> CCCTAGAAGCG
GCCCTCTCGGA -> CCCTCTCGGAG
GCCCTGAGTGA -> CCCTGAGTGAG
GCCGAAAATCA -> CCGAAAATCAA
GCCGACCTGTG -> CCGACCTGTGC
GCCGCCGAAAA -> CCGCCGAAAAT
GCCGCGCAGGC -> CCGCGCAGGCC
GCCGGAATCAG -> CCGGAATCAGA
GCCGTCTCGTG -> CCGTCTCGTGT
GCCGTTAATAG -> CCGTTAATAGG
GCCGTTCGGTG -> CCGTTCGGTGT
GCCTAATATGT -> CCTAATATGTC
GCCTACGCAAA -> CCTACGCAAAA
GCCTATCGACG -> CCTATCGACGC
GCCTCAAGTCG -> CCTCAAGTCGC
GCCTCCAAGAA -> CCTCCAAGAAA
GCCTCGATTTC -> CCTCGATTTCC
GCCTGTAGTCT -> CCTGTAGTCTG
GCCTTTGTTGT -> CCTTTGTTGTA
GCGACGTGCTC -> CGACGTGCTCG
GCGACTACTAC -> CGACTACTACG
GCGAGAAATTA -> CGAGAAATTAT
GCGAGTTCTCG -> CGAGTTCTCGT
GCGATCCGGAT -> CGATCCGGATA
GCGATGCCATG -> CGATGCCATGG
GCGATGTCGCG -> CGATGTCGCGA
GCGCAGGCCTA -> CGCAGGCCTAC
GCGCATACTGT -> CGCATACTGTC
GCGCGATGTCG -> CGCGATGTCGC
GCGCGCTAACA -> CGCGCTAACAA
GCGCTAACAAC -> CGCTAACAACA
GCGCTTAATTT -> CGCTTAATTTT
GCGGAAGATAA -> CGGAAGATAAC
GCGGACGAATA -> CGGACGAATAA
GCGGACTTCTA -> CGGACTTCTAG
GCGGAGCCCCA -> CGGAGCCCCAG
GCGGCAGCAGT -> CGGCAGCAGTC
GCGGCAGGGTC -> CGGCAGGGTCG
GCGGCCGCGCA -> CGGCCGCGCAG
GCGGCCTCGAT -> CGGCCTCGATT
GCGGCTTTCAC -> CGGCTTTCACC
GCGGGACCCCG -> CGGGACCCCGA
GCGGGGGGGGC -> CGGGGGGGGCT
GCGGGTGCGGA -> CGGGTGCGGAC
GCGGTACGGTG -> CGGTACGGTGA
GCGGTTGCACC -> CGGTTGCACCT
GCGTAAAAATA -> CGTAAAAATAG
GCGTTGGAGGC -> CGTTGGAGGCC
GCGTTTGGAAC -> CGTTTGGAACA
GCTAAAGGTGG -> CTAAAGGTGGG
GCTAACAACAC -> CTAACAACACG
GCTAATCTATC -> CTAATCTATCG
GCTACTGTTCA -> CTACTGTTCAA
GCTAGATCATT -> CTAGATCATTT
GCTATATTCGG -> CTATATTCGGT
GCTCACGTCCC -> CTCACGTCCCT
GCTCCATTGCA -> CTCCATTGCAT
GCTCCCGCAGT -> CTCCCGCAGTC
GCTCCCGCTGG -> CTCCCGCTGGC
GCTCGACAACG -> CTCGACAACGC
GCTCGACGGGA -> CTCGACGGGAG
GCTGACGAGCG -> CTGACGAGCGA
GCTGCCAGCAC -> CTGCCAGCACT
GCTGCCGGAAT -> CTGCCGGAATC
GCTGCGCGCTA -> CTGCGCGCTAA
GCTGCTCCCGC -> CTGCTCCCGCT
GCTGCTGCGCG -> CTGCTGCGCGC
GCTGGCACCTG -> CTGGCACCTGG
GCTGGTTTGAG -> CTGGTTTGAGC
GCTGTCATATA -> CTGTCATATAG
GCTTAATTTTT -> CTTAATTTTTA
GCTTAGACAGT -> CTTAGACAGTC
GCTTATATTCC -> CTTATATTCCC
GCTTCGCTAAA -> CTTCGCTAAAG
GCTTGTATCAA -> CTTGTATCAAA
GCTTTCACCTT -> CTTTCACCTTG
GCTTTGAAACA -> CTTTGAAACAG
GCTTTTAAGAA -> CTTTTAAGAAC
GGAACATCACA -> GAACATCACAG
GGAACATGCCT -> GAACATGCCTA
GGAACTCGCCT -> GAACTCGCCTA
GGAAGAAAGAT -> GAAGAAAGATC
GGAAGATAACA -> GAAGATAACAA
GGAATCAGAGA -> GAATCAGAGAA
GGACACATCCT -> GACACATCCTT
GGACACGGTTC -> GACACGGTTCC
GGACAGAACGC -> GACAGAACGCA
GGACCCCGACA -> GACCCCGACAC
GGACCGAATGC -> GACCGAATGCT
GGACGAATAAC -> GACGAATAACA
GGACGCCAGGA -> GACGCCAGGAG
GGACTGTCCAT -> GACTGTCCATT
GGACTTCTAGT -> GACTTCTAGTT
GGACTTTGAGC -> GACTTTGAGCC
GGAGAAACAAC -> GAGAAACAACG
GGAGAAGCCAC -> GAGAAGCCACG
GGAGACTACAT -> GAGACTACATC
GGAGCCCCAGG -> GAGCCCCAGGT
GGAGGCCCTCT -> GAGGCCCTCTC
GGAGGCTTAGA -> GAGGCTTAGAC
GGAGGGTAGGG -> GAGGGTAGGGT
GGAGTGACAGA -> GAGTGACAGAC
GGAGTGGATAG -> GAGTGGATAGA
GGATACAGCTT -> GATACAGCTTG
GGATAGACAAG -> GATAGACAAGA
GGATAGGCATT -> GATAGGCATTT
GGATCTGTAAA -> GATCTGTAAAA
GGATGAGGGCG -> GATGAGGGCGG
GGCAATTAACT -> GCAATTAACTA
GGCACAATATG -> GCACAATATGG
GGCACCTGGCC -> GCACCTGGCCT
GGCAGCAGTCG -> GCAGCAGTCGG
GGCAGGGTCGA -> GCAGGGTCGAA
GGCATTTTCAG -> GCATTTTCAGT
GGCCACTCATT -> GCCACTCATTT
GGCCCTCTCGG -> GCCCTCTCGGA
GGCCGCCGAAA -> GCCGCCGAAAA
GGCCGCGCAGG -> GCCGCGCAGGC
GGCCTACGCAA -> GCCTACGCAAA
GGCCTCAAGTC -> GCCTCAAGTCG
GGCCTCCAAGA -> GCCTCCAAGAA
GGCCTCGATTT -> GCCTCGATTTC
GGCGACTACTA -> GCGACTACTAC
GGCGGAAGATA -> GCGGAAGATAA
GGCGGGGGGGG -> GCGGGGGGGGC
GGCGGGTGCGG -> GCGGGTGCGGA
GGCGGTACGGT -> GCGGTACGGTG
GGCTAGATCAT -> GCTAGATCATT
GGCTCACGTCC -> GCTCACGTCCC
GGCTCCATTGC -> GCTCCATTGCA
GGCTGCTCCCG -> GCTGCTCCCGC
GGCTGTCATAT -> GCTGTCATATA
GGCTTAGACAG -> GCTTAGACAGT
GGCTTATATTC -> GCTTATATTCC
GGCTTCGCTAA -> GCTTCGCTAAA
GGCTTTCACCT -> GCTTTCACCTT
GGCTTTGAAAC -> GCTTTGAAACA
GGGACACATCC -> GGACACATCCT
GGGACACGGTT -> GGACACGGTTC
GGGACCCCGAC -> GGACCCCGACA
GGGACTTTGAG -> GGACTTTGAGC
GGGAGACTACA -> GGAGACTACAT
GGGAGTGACAG -> GGAGTGACAGA
GGGAGTGGATA -> GGAGTGGATAG
GGGCGGTACGG -> GGCGGTACGGT
GGGCTCCATTG -> GGCTCCATTGC
GGGCTTCGCTA -> GGCTTCGCTAA
GGGGCTCCATT -> GGGCTCCATTG
GGGGGCTCCAT -> GGGGCTCCATT
GGGGGGCTCCA -> GGGGGCTCCAT
GGGGGGGCTCC -> GGGGGGCTCCA
GGGGGGGGCTC -> GGGGGGGCTCC
GGGGTAACACC -> GGGTAACACCG
GGGGTTTGCGA -> GGGTTTGCGAT
GGGTAACACCG -> GGTAACACCGA
GGGTACCGTCT -> GGTACCGTCTT
GGGTAGGGTTA -> GGTAGGGTTAA
GGGTCGAAACT -> GGTCGAAACTT
GGGTGCGGACG -> GGTGCGGACGA
GGGTGGCGGGG -> GGTGGCGGGGG
GGGTTAAGCGG -> GGTTAAGCGGC
GGGTTACAAAT -> GGTTACAAATC
GGGTTGGCAAT -> GGTTGGCAATT
GGGTTTGCGAT -> GGTTTGCGATG
GGTAAACAATT -> GTAAACAATTC
GGTAACACCGA -> GTAACACCGAA
GGTAACGTATC -> GTAACGTATCT
GGTACCGTCTT -> GTACCGTCTTG
GGTACGGTGAA -> GTACGGTGAAG
GGTAGCGTTGG -> GTAGCGTTGGA
GGTAGGGTTAA -> GTAGGGTTAAG
GGTATACCAGG -> GTATACCAGGC
GGTATTGTATT -> GTATTGTATTC
GGTCCTTGGGA -> GTCCTTGGGAC
GGTCCTTGGTA -> GTCCTTGGTAT
GGTCGAAACTT -> GTCGAAACTTC
GGTCGATAGTG -> GTCGATAGTGC
GGTCTATGTCC -> GTCTATGTCCT
GGTCTCCACAA -> GTCTCCACAAG
GGTGAAGAGCC -> GTGAAGAGCCC
GGTGAGACGTC -> GTGAGACGTCG
GGTGCGGACGA -> GTGCGGACGAA
GGTGGCGGGGG -> GTGGCGGGGGG
GGTGGGACTTT -> GTGGGACTTTG
GGTGGGTTACA -> GTGGGTTACAA
GGTGTGGTGAG -> GTGTGGTGAGA
GGTTAAGCGGC -> GTTAAGCGGCA
GGTTACAAATC -> GTTACAAATCT
GGTTAGACAGT -> GTTAGACAGTC
GGTTAGAGTTA -> GTTAGAGTTAA
GGTTCATAGTT -> GTTCATAGTTG
GGTTCCCACTC -> GTTCCCACTCT
GGTTCCCTCAC -> GTTCCCTCACG
GGTTGCACCTG -> GTTGCACCTGT
GGTTGGCAATT -> GTTGGCAATTA
GGTTGTCCCTG -> GTTGTCCCTGA
GGTTTGAGCGC -> GTTTGAGCGCG
GGTTTGCCGTC -> GTTTGCCGTCT
GGTTTGCGATG -> GTTTGCGATGC
GGTTTGGCGAC -> GTTTGGCGACT
GGTTTTTCATA -> GTTTTTCATAA
GTAAAAATAGC -> TAAAAATAGCA
GTAAAAGTCAG -> TAAAAGTCAGT
GTAAACAATTC -> TAAACAATTCC
GTAACACCGAA -> TAACACCGAAC
GTAACGTATCT -> TAACGTATCTT
GTAAGAATTCT -> TAAGAATTCTG
GTAAGACGTTT -> TAAGACGTTTA
GTAATGGAGGG -> TAATGGAGGGT
GTACAGAAAGA -> TACAGAAAGAT
GTACAGATTCC -> TACAGATTCCC
GTACCGTCTTG -> TACCGTCTTGA
GTACGGTGAAG -> TACGGTGAAGA
GTAGCGTTGGA -> TAGCGTTGGAG
GTAGGGACACA -> TAGGGACACAT
GTAGGGTTAAG -> TAGGGTTAAGC
GTAGTCTGACC -> TAGTCTGACCG
GTATACCAGGC -> TATACCAGGCT
GTATATCCAGT -> TATATCCAGTG
GTATCAAACGC -> TATCAAACGCG
GTATCAGTACA -> TATCAGTACAG
GTATCTTACGC -> TATCTTACGCC
GTATTCCTAGC -> TATTCCTAGCC
GTATTGTATTC -> TATTGTATTCC
GTCACAGTTGC -> TCACAGTTGCA
GTCAGAATACA -> TCAGAATACAG
GTCAGTCCTCC -> TCAGTCCTCCC
GTCAGTCGTGT -> TCAGTCGTGTG
GTCATAGCTGC -> TCATAGCTGCC
GTCATATAGGG -> TCATATAGGGC
GTCATCTCGAC -> TCATCTCGACT
GTCCATTGGCT -> TCCATTGGCTA
GTCCCTGATCC -> TCCCTGATCCT
GTCCCTGTTAC -> TCCCTGTTACC
GTCCCTTAATG -> TCCCTTAATGT
GTCCTCCCATA -> TCCTCCCATAC
GTCCTCTGATA -> TCCTCTGATAT
GTCCTTGGCGG -> TCCTTGGCGGG
GTCCTTGGGAC -> TCCTTGGGACA
GTCCTTGGTAT -> TCCTTGGTATT
GTCGAAACTTC -> TCGAAACTTCG
GTCGACTCGCG -> TCGACTCGCGG
GTCGAGGTCCT -> TCGAGGTCCTT
GTCGAGTGTCT -> TCGAGTGTCTT
GTCGATAGTGC -> TCGATAGTGCA
GTCGCAAGCGG -> TCGCAAGCGGC
GTCGCCTTTGT -> TCGCCTTTGTT
GTCGCGAGTTC -> TCGCGAGTTCT
GTCGCTCCCGC -> TCGCTCCCGCA
GTCGGATGAGG -> TCGGATGAGGG
GTCGGCTCACG -> TCGGCTCACGT
GTCGTGTGGTA -> TCGTGTGGTAA
GTCTACAGAAA -> TCTACAGAAAC
GTCTATGTCCT -> TCTATGTCCTC
GTCTCCACAAG -> TCTCCACAAGA
GTCTCGTGTGG -> TCTCGTGTGGC
GTCTGACCGTA -> TCTGACCGTAT
GTCTTCGGACA -> TCTTCGGACAG
GTCTTGAGGTT -> TCTTGAGGTTT
GTGAAGAGCCC -> TGAAGAGCCCT
GTGACAGACCC -> TGACAGACCCT
GTGAGACGTCG -> TGAGACGTCGA
GTGAGGTTAGA -> TGAGGTTAGAC
GTGAGTCAGAA -> TGAGTCAGAAT
GTGCAAGTGGC -> TGCAAGTGGCT
GTGCGGACGAA -> TGCGGACGAAT
GTGCGGCTTTC -> TGCGGCTTTCA
GTGCGGGACCC -> TGCGGGACCCC
GTGCTCGACAA -> TGCTCGACAAC
GTGCTGCCAGC -> TGCTGCCAGCA
GTGGATAGACA -> TGGATAGACAA
GTGGATAGGCA -> TGGATAGGCAT
GTGGCCGCCGA -> TGGCCGCCGAA
GTGGCGGGGGG -> TGGCGGGGGGG
GTGGCTTTGAA -> TGGCTTTGAAA
GTGGGACTTTG -> TGGGACTTTGA
GTGGGAGTGGA -> TGGGAGTGGAT
GTGGGTTACAA -> TGGGTTACAAA
GTGGTAAACAA -> TGGTAAACAAT
GTGGTGAGACG -> TGGTGAGACGT
GTGGTTTGCCG -> TGGTTTGCCGT
GTGTAATGGAG -> TGTAATGGAGG
GTGTCTTCGGA -> TGTCTTCGGAC
GTGTGGCCGCC -> TGTGGCCGCCG
GTGTGGTAAAC -> TGTGGTAAACA
GTGTGGTGAGA -> TGTGGTGAGAC
GTTAAGAGGCG -> TTAAGAGGCGG
GTTAAGCGGCA -> TTAAGCGGCAG
GTTAATAGGTA -> TTAATAGGTAT
GTTACAAATCT -> TTACAAATCTA
GTTACCACGGA -> TTACCACGGAA
GTTAGACAGTC -> TTAGACAGTCG
GTTAGAGTTAA -> TTAGAGTTAAG
GTTCAAGATCG -> TTCAAGATCGA
GTTCATAGTTG -> TTCATAGTTGG
GTTCCCACTCT -> TTCCCACTCTC
GTTCCCTCACG -> TTCCCTCACGG
GTTCGATCTCC -> TTCGATCTCCC
GTTCGGTGTGG -> TTCGGTGTGGT
GTTCTCGTGGA -> TTCTCGTGGAT
GTTCTGCTAAT -> TTCTGCTAATC
GTTCTTATCTG -> TTCTTATCTGT
GTTGCACCTGT -> TTGCACCTGTT
GTTGCATAGGG -> TTGCATAGGGG
GTTGGAGAAAC -> TTGGAGAAACA
GTTGGAGGCCC -> TTGGAGGCCCT
GTTGGCAATTA -> TTGGCAATTAA
GTTGGGGTAAC -> TTGGGGTAACA
GTTGTAAGACG -> TTGTAAGACGT
GTTGTCCCTGA -> TTGTCCCTGAT
GTTTACTCCGA -> TTTACTCCGAG
GTTTGAGCGCG -> TTTGAGCGCGA
GTTTGCCGTCT -> TTTGCCGTCTC
GTTTGCGATGC -> TTTGCGATGCC
GTTTGCTGGTT -> TTTGCTGGTTT
GTTTGGAACAT -> TTTGGAACATG
GTTTGGCGACT -> TTTGGCGACTA
GTTTTTCATAA -> TTTTTCATAAG
TAAAAATAGCA -> AAAAATAGCAC
TAAAACAACGC -> AAAACAACGCA
TAAAAGTCAGT -> AAAAGTCAGTC
TAAACAATTCC -> AAACAATTCCC
TAAAGCAAGCA -> AAAGCAAGCAC
TAAAGGTGGGA -> AAAGGTGGGAC
TAACAACACGT -> AACAACACGTC
TAACAATGGTA -> AACAATGGTAA
TAACACCGAAC -> AACACCGAACA
TAACAGAGGCC -> AACAGAGGCCT
TAACGTATCTT -> AACGTATCTTA
TAACTATTGGA -> AACTATTGGAC
TAAGAACCCGA -> AAGAACCCGAG
TAAGAATTCTG -> AAGAATTCTGT
TAAGACGTTTA -> AAGACGTTTAC
TAAGAGGCGGA -> AAGAGGCGGAA
TAAGCGGCAGC -> AAGCGGCAGCA
TAAGGCTGCTC -> AAGGCTGCTCC
TAAGGTCTATG -> AAGGTCTATGT
TAAGTCCTTGG -> AAGTCCTTGGC
TAATAGGTATA -> AATAGGTATAC
TAATAGGTGGG -> AATAGGTGGGT
TAATATGTCAT -> AATATGTCATA
TAATCTATCGC -> AATCTATCGCT
TAATGGAGGGT -> AATGGAGGGTA
TAATGTCGCAA -> AATGTCGCAAG
TAATTATGAAG -> AATTATGAAGC
TAATTTTTAAA -> AATTTTTAAAG
TACAAATCTAG -> ACAAATCTAGG
TACACCACCTG -> ACACCACCTGC
TACAGAAACTA -> ACAGAAACTAG
TACAGAAAGAT -> ACAGAAAGATA
TACAGACGTCG -> ACAGACGTCGA
TACAGATTCCC -> ACAGATTCCCA
TACAGCTTGTA -> ACAGCTTGTAT
TACATCACTGG -> ACATCACTGGA
TACCACGGAAG -> ACCACGGAAGA
TACCAGGCTGT -> ACCAGGCTGTC
TACCCCCAACT -> ACCCCCAACTC
TACCGTCTTGA -> ACCGTCTTGAG
TACCGTGCGGC -> ACCGTGCGGCT
TACCTACCGTG -> ACCTACCGTGC
TACGCAAAACC -> ACGCAAAACCC
TACGCCAATCG -> ACGCCAATCGC
TACGCCCTGAG -> ACGCCCTGAGT
TACGGTGAAGA -> ACGGTGAAGAG
TACGTATATCC -> ACGTATATCCA
TACGTCACAGT -> ACGTCACAGTT
TACTACGTATA -> ACTACGTATAT
TACTCCGAGGT -> ACTCCGAGGTT
TACTGTCGAGT -> ACTGTCGAGTG
TACTGTTCAAG -> ACTGTTCAAGA
TAGAAGCGATC -> AGAAGCGATCC
TAGACAAGAAA -> AGACAAGAAAT
TAGACAGTCGC -> AGACAGTCGCC
TAGACAGTCGG -> AGACAGTCGGC
TAGAGTTAAGA -> AGAGTTAAGAG
TAGATCATTTG -> AGATCATTTGC
TAGATGCTATA -> AGATGCTATAT
TAGCACTCCAC -> AGCACTCCACG
TAGCCCCACGT -> AGCCCCACGTA
TAGCGTTGGAG -> AGCGTTGGAGG
TAGCTGCCGGA -> AGCTGCCGGAA
TAGGAACATCA -> AGGAACATCAC
TAGGCATTTTC -> AGGCATTTTCA
TAGGGACACAT -> AGGGACACATC
TAGGGCTTCGC -> AGGGCTTCGCT
TAGGGGTTTGC -> AGGGGTTTGCG
TAGGGTTAAGC -> AGGGTTAAGCG
TAGGTATACCA -> AGGTATACCAG
TAGGTCCTTGG -> AGGTCCTTGGT
TAGGTGGGTTA -> AGGTGGGTTAC
TAGTCTGACCG -> AGTCTGACCGT
TAGTGCAAGTG -> AGTGCAAGTGG
TAGTTGGAGAA -> AGTTGGAGAAA
TAGTTTGCTGG -> AGTTTGCTGGT
TATAAAACAAC -> ATAAAACAACG
TATACCAGGCT -> ATACCAGGCTG
TATAGGGCTTC -> ATAGGGCTTCG
TATATCCAGTG -> ATATCCAGTGC
TATATTCCCGG -> ATATTCCCGGT
TATATTCGGTC -> ATATTCGGTCG
TATCAAACGCG -> ATCAAACGCGT
TATCAGTACAG -> ATCAGTACAGA
TATCCAGTGCG -> ATCCAGTGCGG
TATCGACGCAA -> ATCGACGCAAA
TATCGCTACTG -> ATCGCTACTGT
TATCTGTTGGG -> ATCTGTTGGGG
TATCTTACGCC -> ATCTTACGCCA
TATGAAGCAGT -> ATGAAGCAGTT
TATGGATCTGT -> ATGGATCTGTA
TATGGGTACCG -> ATGGGTACCGT
TATGTCATAGC -> ATGTCATAGCT
TATGTCCTCTG -> ATGTCCTCTGA
TATTCCCGGTT -> ATTCCCGGTTC
TATTCCTAGCC -> ATTCCTAGCCC
TATTCGGTCGA -> ATTCGGTCGAT
TATTGGACTGT -> ATTGGACTGTC
TATTGTATTCC -> ATTGTATTCCT
TCAAACGCGTA -> CAAACGCGTAA
TCAAATCTGCG -> CAAATCTGCGC
TCAACACAAGC -> CAACACAAGCA
TCAAGATCGAT -> CAAGATCGATA
TCAAGTCGCTC -> CAAGTCGCTCC
TCAATCGGGTG -> CAATCGGGTGG
TCACAGATACG -> CACAGATACGT
TCACAGTTGCA -> CACAGTTGCAT
TCACATTGTGT -> CACATTGTGTA
TCACCTTGCGG -> CACCTTGCGGC
TCACGGAACTC -> CACGGAACTCG
TCACGTCCCTG -> CACGTCCCTGT
TCACTGGACCG -> CACTGGACCGA
TCAGAATACAG -> CAGAATACAGA
TCAGAGAATTG -> CAGAGAATTGC
TCAGTACAGAA -> CAGTACAGAAA
TCAGTCCTCCC -> CAGTCCTCCCA
TCAGTCGTGTG -> CAGTCGTGTGG
TCAGTTCTGCT -> CAGTTCTGCTA
TCATAAGGCTG -> CATAAGGCTGC
TCATAAGTCCT -> CATAAGTCCTT
TCATAGCTGCC -> CATAGCTGCCG
TCATAGTTGGA -> CATAGTTGGAG
TCATATAGGGC -> CATATAGGGCT
TCATCTCGACT -> CATCTCGACTG
TCATTTCGGTT -> CATTTCGGTTA
TCATTTGCGTT -> CATTTGCGTTT
TCCAAGAAAAC -> CCAAGAAAACC
TCCACAAGAAA -> CCACAAGAAAC
TCCACGAACGC -> CCACGAACGCG
TCCAGATACAC -> CCAGATACACC
TCCAGTGCGGG -> CCAGTGCGGGA
TCCATTGCATC -> CCATTGCATCA
TCCATTGGCTA -> CCATTGGCTAG
TCCCACTCTCA -> CCCACTCTCAA
TCCCATACCCC -> CCCATACCCCC
TCCCATCGGTC -> CCCATCGGTCT
TCCCGAAAGGC -> CCCGAAAGGCT
TCCCGCAGTCC -> CCCGCAGTCCC
TCCCGCTGGCA -> CCCGCTGGCAC
TCCCGGTTCAT -> CCCGGTTCATA
TCCCGTACAGA -> CCCGTACAGAT
TCCCTCACGGA -> CCCTCACGGAA
TCCCTGATCCT -> CCCTGATCCTA
TCCCTGTTACC -> CCCTGTTACCA
TCCCTTAATGT -> CCCTTAATGTC
TCCGAGGTTTT -> CCGAGGTTTTT
TCCGGATACAG -> CCGGATACAGC
TCCTACCTACC -> CCTACCTACCG
TCCTAGCCCCA -> CCTAGCCCCAC
TCCTCCCATAC -> CCTCCCATACC
TCCTCTGATAT -> CCTCTGATATG
TCCTCTGCCAA -> CCTCTGCCAAG
TCCTTGAAGAG -> CCTTGAAGAGC
TCCTTGGCGGG -> CCTTGGCGGGT
TCCTTGGGACA -> CCTTGGGACAC
TCCTTGGTATT -> CCTTGGTATTG
TCGAAACTTCG -> CGAAACTTCGA
TCGACAACGCT -> CGACAACGCTC
TCGACGATACG -> CGACGATACGC
TCGACGCAAAT -> CGACGCAAATA
TCGACGGGAGA -> CGACGGGAGAC
TCGACTCGCGG -> CGACTCGCGGA
TCGACTGGCAC -> CGACTGGCACA
TCGAGGTCCTT -> CGAGGTCCTTG
TCGAGTGTCTT -> CGAGTGTCTTC
TCGATAAGGTC -> CGATAAGGTCT
TCGATAGTGCA -> CGATAGTGCAA
TCGATCTCCCG -> CGATCTCCCGT
TCGATTTCCTC -> CGATTTCCTCT
TCGCAAGCGGC -> CGCAAGCGGCC
TCGCCTAATAT -> CGCCTAATATG
TCGCCTTTGTT -> CGCCTTTGTTG
TCGCGAGTTCT -> CGCGAGTTCTC
TCGCGGAGCCC -> CGCGGAGCCCC
TCGCGGTTGCA -> CGCGGTTGCAC
TCGCTAAAGGT -> CGCTAAAGGTG
TCGCTACTGTT -> CGCTACTGTTC
TCGCTCCCGCA -> CGCTCCCGCAG
TCGCTTTTAAG -> CGCTTTTAAGA
TCGGACAGAAC -> CGGACAGAACG
TCGGAGAAGCC -> CGGAGAAGCCA
TCGGATGAGGG -> CGGATGAGGGC
TCGGCTCACGT -> CGGCTCACGTC
TCGGGTGGCGG -> CGGGTGGCGGG
TCGGTCGATAG -> CGGTCGATAGT
TCGGTCTCCAC -> CGGTCTCCACA
TCGGTGTGGTG -> CGGTGTGGTGA
TCGGTTAGAGT -> CGGTTAGAGTT
TCGTGGATAGG -> CGTGGATAGGC
TCGTGTGGCCG -> CGTGTGGCCGC
TCGTGTGGTAA -> CGTGTGGTAAA
TCTACAGAAAC -> CTACAGAAACT
TCTAGGTCCTT -> CTAGGTCCTTG
TCTAGTTTGCT -> CTAGTTTGCTG
TCTATCGCTAC -> CTATCGCTACT
TCTATGTCCTC -> CTATGTCCTCT
TCTCAAATCTG -> CTCAAATCTGC
TCTCCACAAGA -> CTCCACAAGAA
TCTCCCGTACA -> CTCCCGTACAG
TCTCGACTGGC -> CTCGACTGGCA
TCTCGCGGTTG -> CTCGCGGTTGC
TCTCGGAGAAG -> CTCGGAGAAGC
TCTCGTGGATA -> CTCGTGGATAG
TCTCGTGTGGC -> CTCGTGTGGCC
TCTGACCGTAT -> CTGACCGTATC
TCTGACCGTGG -> CTGACCGTGGG
TCTGATATGGG -> CTGATATGGGT
TCTGCCAAGAC -> CTGCCAAGACT
TCTGCGCATAC -> CTGCGCATACT
TCTGCTAATCT -> CTGCTAATCTA
TCTGTAAAAGT -> CTGTAAAAGTC
TCTGTCATCTC -> CTGTCATCTCG
TCTGTTGGGGT -> CTGTTGGGGTA
TCTTACGCCAA -> CTTACGCCAAT
TCTTATCTGTT -> CTTATCTGTTG
TCTTCGGACAG -> CTTCGGACAGA
TCTTGAGGTTT -> CTTGAGGTTTG
TCTTGCGGCCG -> CTTGCGGCCGC
TGAAACAGCGA -> GAAACAGCGAC
TGAAGAGCCCT -> GAAGAGCCCTA
TGAAGAGCTGA -> GAAGAGCTGAC
TGAAGCAGTTC -> GAAGCAGTTCG
TGACAGACCCT -> GACAGACCCTG
TGACCGCCGAC -> GACCGCCGACC
TGACCGTATCA -> GACCGTATCAG
TGACCGTGGGA -> GACCGTGGGAG
TGACGAGCGAG -> GACGAGCGAGA
TGAGACGTCGA -> GAGACGTCGAG
TGAGCCTGTAG -> GAGCCTGTAGT
TGAGCGCGATG -> GAGCGCGATGT
TGAGGGCGGTA -> GAGGGCGGTAC
TGAGGTTAGAC -> GAGGTTAGACA
TGAGGTTTGGC -> GAGGTTTGGCG
TGAGTCAGAAT -> GAGTCAGAATA
TGAGTGAGTCA -> GAGTGAGTCAG
TGATATGGGTA -> GATATGGGTAC
TGATCCTACCT -> GATCCTACCTA
TGCAAGTGGCT -> GCAAGTGGCTT
TGCACCTGTTC -> GCACCTGTTCT
TGCATAGGGGT -> GCATAGGGGTT
TGCATCATAAG -> GCATCATAAGT
TGCCAAGACTT -> GCCAAGACTTC
TGCCAGCACTC -> GCCAGCACTCT
TGCCATGGCCA -> GCCATGGCCAC
TGCCGGAATCA -> GCCGGAATCAG
TGCCGTCTCGT -> GCCGTCTCGTG
TGCCGTTAATA -> GCCGTTAATAG
TGCCTATCGAC -> GCCTATCGACG
TGCGATGCCAT -> GCGATGCCATG
TGCGCATACTG -> GCGCATACTGT
TGCGCGCTAAC -> GCGCGCTAACA
TGCGCTTAATT -> GCGCTTAATTT
TGCGGACGAAT -> GCGGACGAATA
TGCGGCAGGGT -> GCGGCAGGGTC
TGCGGCCGCGC -> GCGGCCGCGCA
TGCGGCTTTCA -> GCGGCTTTCAC
TGCGGGACCCC -> GCGGGACCCCG
TGCGTTTGGAA -> GCGTTTGGAAC
TGCTAATCTAT -> GCTAATCTATC
TGCTATATTCG -> GCTATATTCGG
TGCTCCCGCTG -> GCTCCCGCTGG
TGCTCGACAAC -> GCTCGACAACG
TGCTGCCAGCA -> GCTGCCAGCAC
TGCTGCGCGCT -> GCTGCGCGCTA
TGCTGCTGCGC -> GCTGCTGCGCG
TGCTGGTTTGA -> GCTGGTTTGAG
TGGAACATGCC -> GGAACATGCCT
TGGACCGAATG -> GGACCGAATGC
TGGACTGTCCA -> GGACTGTCCAT
TGGAGAAACAA -> GGAGAAACAAC
TGGAGGCCCTC -> GGAGGCCCTCT
TGGAGGGTAGG -> GGAGGGTAGGG
TGGATAGACAA -> GGATAGACAAG
TGGATAGGCAT -> GGATAGGCATT
TGGATCTGTAA -> GGATCTGTAAA
TGGCAATTAAC -> GGCAATTAACT
TGGCACAATAT -> GGCACAATATG
TGGCACCTGGC -> GGCACCTGGCC
TGGCCACTCAT -> GGCCACTCATT
TGGCCGCCGAA -> GGCCGCCGAAA
TGGCCTCAAGT -> GGCCTCAAGTC
TGGCGACTACT -> GGCGACTACTA
TGGCGGGGGGG -> GGCGGGGGGGG
TGGCGGGTGCG -> GGCGGGTGCGG
TGGCTAGATCA -> GGCTAGATCAT
TGGCTTTGAAA -> GGCTTTGAAAC
TGGGACACGGT -> GGGACACGGTT
TGGGACTTTGA -> GGGACTTTGAG
TGGGAGTGGAT -> GGGAGTGGATA
TGGGGTAACAC -> GGGGTAACACC
TGGGTACCGTC -> GGGTACCGTCT
TGGGTTACAAA -> GGGTTACAAAT
TGGGTTGGCAA -> GGGTTGGCAAT
TGGTAAACAAT -> GGTAAACAATT
TGGTAACGTAT -> GGTAACGTATC
TGGTATTGTAT -> GGTATTGTATT
TGGTGAGACGT -> GGTGAGACGTC
TGGTTTGAGCG -> GGTTTGAGCGC
TGGTTTGCCGT -> GGTTTGCCGTC
TGTAAAAGTCA -> GTAAAAGTCAG
TGTAAGACGTT -> GTAAGACGTTT
TGTAATGGAGG -> GTAATGGAGGG
TGTAGTCTGAC -> GTAGTCTGACC
TGTATCAAACG -> GTATCAAACGC
TGTATTCCTAG -> GTATTCCTAGC
TGTCATAGCTG -> GTCATAGCTGC
TGTCATATAGG -> GTCATATAGGG
TGTCATCTCGA -> GTCATCTCGAC
TGTCCATTGGC -> GTCCATTGGCT
TGTCCCTGATC -> GTCCCTGATCC
TGTCCTCTGAT -> GTCCTCTGATA
TGTCGAGTGTC -> GTCGAGTGTCT
TGTCGCAAGCG -> GTCGCAAGCGG
TGTCGCGAGTT -> GTCGCGAGTTC
TGTCTACAGAA -> GTCTACAGAAA
TGTCTTCGGAC -> GTCTTCGGACA
TGTGCTGCCAG -> GTGCTGCCAGC
TGTGGCCGCCG -> GTGGCCGCCGA
TGTGGTAAACA -> GTGGTAAACAA
TGTGGTGAGAC -> GTGGTGAGACG
TGTGTAATGGA -> GTGTAATGGAG
TGTTACCACGG -> GTTACCACGGA
TGTTCAAGATC -> GTTCAAGATCG
TGTTCTTATCT -> GTTCTTATCTG
TGTTGGGGTAA -> GTTGGGGTAAC
TGTTGTAAGAC -> GTTGTAAGACG
TTAAAGCAAGC -> TAAAGCAAGCA
TTAACTATTGG -> TAACTATTGGA
TTAAGAACCCG -> TAAGAACCCGA
TTAAGAGGCGG -> TAAGAGGCGGA
TTAAGCGGCAG -> TAAGCGGCAGC
TTAATAGGTAT -> TAATAGGTATA
TTAATGTCGCA -> TAATGTCGCAA
TTAATTTTTAA -> TAATTTTTAAA
TTACAAATCTA -> TACAAATCTAG
TTACCACGGAA -> TACCACGGAAG
TTACGCCAATC -> TACGCCAATCG
TTACTCCGAGG -> TACTCCGAGGT
TTAGACAGTCG -> TAGACAGTCGC,TAGACAGTCGG
TTAGAGTTAAG -> TAGAGTTAAGA
TTATAAAACAA -> TATAAAACAAC
TTATATTCCCG -> TATATTCCCGG
TTATCTGTTGG -> TATCTGTTGGG
TTATGAAGCAG -> TATGAAGCAGT
TTCAAGATCGA -> TCAAGATCGAT
TTCACATTGTG -> TCACATTGTGT
TTCACCTTGCG -> TCACCTTGCGG
TTCAGTTCTGC -> TCAGTTCTGCT
TTCATAAGGCT -> TCATAAGGCTG
TTCATAGTTGG -> TCATAGTTGGA
TTCCCACTCTC -> TCCCACTCTCA
TTCCCATCGGT -> TCCCATCGGTC
TTCCCGAAAGG -> TCCCGAAAGGC
TTCCCGGTTCA -> TCCCGGTTCAT
TTCCCTCACGG -> TCCCTCACGGA
TTCCTAGCCCC -> TCCTAGCCCCA
TTCCTCTGCCA -> TCCTCTGCCAA
TTCGACGATAC -> TCGACGATACG
TTCGATCTCCC -> TCGATCTCCCG
TTCGCTAAAGG -> TCGCTAAAGGT
TTCGGACAGAA -> TCGGACAGAAC
TTCGGTCGATA -> TCGGTCGATAG
TTCGGTGTGGT -> TCGGTGTGGTG
TTCGGTTAGAG -> TCGGTTAGAGT
TTCTAGTTTGC -> TCTAGTTTGCT
TTCTCGCGGTT -> TCTCGCGGTTG
TTCTCGTGGAT -> TCTCGTGGATA
TTCTGCTAATC -> TCTGCTAATCT
TTCTGTCATCT -> TCTGTCATCTC
TTCTTATCTGT -> TCTTATCTGTT
TTGAAACAGCG -> TGAAACAGCGA
TTGAAGAGCTG -> TGAAGAGCTGA
TTGAGCCTGTA -> TGAGCCTGTAG
TTGAGCGCGAT -> TGAGCGCGATG
TTGAGGTTTGG -> TGAGGTTTGGC
TTGCACCTGTT -> TGCACCTGTTC
TTGCATAGGGG -> TGCATAGGGGT
TTGCATCATAA -> TGCATCATAAG
TTGCCGTCTCG -> TGCCGTCTCGT
TTGCCGTTAAT -> TGCCGTTAATA
TTGCGATGCCA -> TGCGATGCCAT
TTGCGGCAGGG -> TGCGGCAGGGT
TTGCGGCCGCG -> TGCGGCCGCGC
TTGCGTTTGGA -> TGCGTTTGGAA
TTGCTGGTTTG -> TGCTGGTTTGA
TTGGAACATGC -> TGGAACATGCC
TTGGACTGTCC -> TGGACTGTCCA
TTGGAGAAACA -> TGGAGAAACAA
TTGGAGGCCCT -> TGGAGGCCCTC
TTGGCAATTAA -> TGGCAATTAAC
TTGGCGACTAC -> TGGCGACTACT
TTGGCGGGTGC -> TGGCGGGTGCG
TTGGCTAGATC -> TGGCTAGATCA
TTGGGACACGG -> TGGGACACGGT
TTGGGGTAACA -> TGGGGTAACAC
TTGGTATTGTA -> TGGTATTGTAT
TTGTAAGACGT -> TGTAAGACGTT
TTGTATCAAAC -> TGTATCAAACG
TTGTATTCCTA -> TGTATTCCTAG
TTGTCCCTGAT -> TGTCCCTGATC
TTGTCTACAGA -> TGTCTACAGAA
TTGTGTAATGG -> TGTGTAATGGA
TTGTTGTAAGA -> TGTTGTAAGAC
TTTAAAGCAAG -> TTAAAGCAAGC
TTTAAGAACCC -> TTAAGAACCCG
TTTACTCCGAG -> TTACTCCGAGG
TTTCACCTTGC -> TTCACCTTGCG
TTTCAGTTCTG -> TTCAGTTCTGC
TTTCATAAGGC -> TTCATAAGGCT
TTTCCTCTGCC -> TTCCTCTGCCA
TTTCGGTTAGA -> TTCGGTTAGAG
TTTGAAACAGC -> TTGAAACAGCG
TTTGAGCCTGT -> TTGAGCCTGTA
TTTGAGCGCGA -> TTGAGCGCGAT
TTTGCCGTCTC -> TTGCCGTCTCG
TTTGCGATGCC -> TTGCGATGCCA
TTTGCGTTTGG -> TTGCGTTTGGA
TTTGCTGGTTT -> TTGCTGGTTTG
TTTGGAACATG -> TTGGAACATGC
TTTGGCGACTA -> TTGGCGACTAC
TTTGTTGTAAG -> TTGTTGTAAGA
TTTTAAAGCAA -> TTTAAAGCAAG
TTTTAAGAACC -> TTTAAGAACCC
TTTTCAGTTCT -> TTTCAGTTCTG
TTTTCATAAGG -> TTTCATAAGGC
TTTTTAAAGCA -> TTTTAAAGCAA
TTTTTCATAAG -> TTTTCATAAGG
