CATCAGACTTACCTGTTATCGAAG -> ATCAGACTTACCTGTTATCGAAGA
ACGGAGTTGACCCAATGAGAGCGC -> CGGAGTTGACCCAATGAGAGCGCC
AGTATCGCGGATGAGAACAATGTG -> GTATCGCGGATGAGAACAATGTGA
GTAGCCGAAAGCCCGACGGCCACT -> TAGCCGAAAGCCCGACGGCCACTG
ATCGTTGTGAACTGAGCAGCTGCG -> TCGTTGTGAACTGAGCAGCTGCGC
TACCTGGGGCCCGGGGGTAGCCTC -> ACCTGGGGCCCGGGGGTAGCCTCC
CACCATTTTCAATCATATTGATCC -> ACCATTTTCAATCATATTGATCCT
CCTGTTAGGGTTGGATCCGAACAC -> CTGTTAGGGTTGGATCCGAACACC
CTGATACATGCGGGCTTTATCAGA -> TGATACATGCGGGCTTTATCAGAC
GCGAGTGCTATGTCGACAAGGGCT -> CGAGTGCTATGTCGACAAGGGCTT
TCCCGGGGCCCCTGAGACTCGAGG -> CCCGGGGCCCCTGAGACTCGAGGA
GTCCGCCAGACGCTAAACATGCCG -> TCCGCCAGACGCTAAACATGCCGA
TTAGCGAGCGGTGGCGGATGTTAG -> TAGCGAGCGGTGGCGGATGTTAGA
CCTGGGTAACCTAACGGGGCCGGC -> CTGGGTAACCTAACGGGGCCGGCT
CCCTGAGACTCGAGGAGATAGCCT -> CCTGAGACTCGAGGAGATAGCCTC
TCAGACTTACCTGTTATCGAAGAT -> CAGACTTACCTGTTATCGAAGATT
TGACAGCCCAATCTAGGCTCTAGG -> GACAGCCCAATCTAGGCTCTAGGG
TTTTCACCAGACCTGTTAGGGTTG -> TTTCACCAGACCTGTTAGGGTTGG
CAGAAACTCGGATGAACCGCTGGA -> AGAAACTCGGATGAACCGCTGGAG
CGATTACCTAATAGTCCGTGAAGG -> GATTACCTAATAGTCCGTGAAGGG
GTTATCCCACCAATCACAGCATGT -> TTATCCCACCAATCACAGCATGTT
ATTTAAAGACTGCGATGGAATTAT -> TTTAAAGACTGCGATGGAATTATA
CGACGGCCACTGTCACCCTCCCGT -> GACGGCCACTGTCACCCTCCCGTC
GGCTTATGGGGGTAGCCGAAAGCC -> GCTTATGGGGGTAGCCGAAAGCCC
AGCTGCGCCCGGCTACAGCGAGCG -> GCTGCGCCCGGCTACAGCGAGCGG
AACTGAGCAGCTGCGCCCGGCTAC -> ACTGAGCAGCTGCGCCCGGCTACA
TGGCCGTTATCCCACCAATCACAG -> GGCCGTTATCCCACCAATCACAGC
CATCAGACAGAAACTCGGATGAAC -> ATCAGACAGAAACTCGGATGAACC
TCTTCCTAGATGTCGGATCTTTCA -> CTTCCTAGATGTCGGATCTTTCAG
CATAGAGAAGGGTGTGGTCGAACA -> ATAGAGAAGGGTGTGGTCGAACAA
AGATGATCACTGAAGAGTTACAGA -> GATGATCACTGAAGAGTTACAGAT
GAGAGCATGTCGAGAGATTAAAAA -> AGAGCATGTCGAGAGATTAAAAAC
ACATGCGGGCTTTATCAGACCTGA -> CATGCGGGCTTTATCAGACCTGAC
TACGCGCATTAGATCGTTGTGAAC -> ACGCGCATTAGATCGTTGTGAACT
GCCCGTAAGATGGGACGGTACCAG -> CCCGTAAGATGGGACGGTACCAGC
GCCTGCCTAGACATAGAGACTGAC -> CCTGCCTAGACATAGAGACTGACG
TCCGTGAAGGGTCAGTATCGCGGA -> CCGTGAAGGGTCAGTATCGCGGAT
GTAGCCTCCGTGCCTCCCGGGGCC -> TAGCCTCCGTGCCTCCCGGGGCCC
GGCAGCGTACAGAAAATCAAGCAT -> GCAGCGTACAGAAAATCAAGCATA
CGGACACGATCACGCGAGAAACGT -> GGACACGATCACGCGAGAAACGTT
CTCAGTGCCACCCGCGGGAAACTC -> TCAGTGCCACCCGCGGGAAACTCT
TCCCGTCCAGTGCCTGCCTAGACA -> CCCGTCCAGTGCCTGCCTAGACAT
TGTCGGATCTTTCAGAAACTCAGT -> GTCGGATCTTTCAGAAACTCAGTG
TTCAATTAGGCGCAACAAAGACAT -> TCAATTAGGCGCAACAAAGACATT
GTGTGGTCGAACAAGATGGCCACG -> TGTGGTCGAACAAGATGGCCACGT
TGGAGGCCGACGTTTCGCTATGGA -> GGAGGCCGACGTTTCGCTATGGAA
GAAAATTCCGGCCATGTAGCGTAG -> AAAATTCCGGCCATGTAGCGTAGT
CGCGCCCTCCCGTAACACATTCAA -> GCGCCCTCCCGTAACACATTCAAA
GAACATGCAGCTGAAGCGTCGGGC -> AACATGCAGCTGAAGCGTCGGGCC
AATTGGACTACACATACGTGTGTA -> ATTGGACTACACATACGTGTGTAG
GCTTTCGTCGAATGAAGCGCGTGT -> CTTTCGTCGAATGAAGCGCGTGTA
GACGCACAGACATTAGGGTTCATG -> ACGCACAGACATTAGGGTTCATGG
ACCATACTTCAGCCAATTGGAGCA -> CCATACTTCAGCCAATTGGAGCAC
ACTGTCACCCTCCCGTCCAGTGCC -> CTGTCACCCTCCCGTCCAGTGCCT
CAGTTTGTTTACCATGGTTCGGGT -> AGTTTGTTTACCATGGTTCGGGTG
GCTCTAGGGGGCTAGCGCATACCA -> CTCTAGGGGGCTAGCGCATACCAT
GGAAAAAAAGTTGTGTTCTGGATG -> GAAAAAAAGTTGTGTTCTGGATGT
ATCACCGCTAAGTGGCCAATCTGA -> TCACCGCTAAGTGGCCAATCTGAG
CATTCGCGTCACGCCGCATTGCAT -> ATTCGCGTCACGCCGCATTGCATC
TTACCTAATAGTCCGTGAAGGGTC -> TACCTAATAGTCCGTGAAGGGTCA
CCTAATAGTCCGTGAAGGGTCAGT -> CTAATAGTCCGTGAAGGGTCAGTA
GTCTTTCCCTATTCCTAAGCCGGA -> TCTTTCCCTATTCCTAAGCCGGAT
GCGGGGGTTTTCACCAGACCTGTT -> CGGGGGTTTTCACCAGACCTGTTA
GTTGAGCGAGCGCGAGTGCTATGT -> TTGAGCGAGCGCGAGTGCTATGTC
CTCCCGTCCAGTGCCTGCCTAGAC -> TCCCGTCCAGTGCCTGCCTAGACA
ATGTGAAACTTGAAGATTTCTGCC -> TGTGAAACTTGAAGATTTCTGCCC
TGCCTAGACATAGAGACTGACGGA -> GCCTAGACATAGAGACTGACGGAC
TGTTAGGGTTGGATCCGAACACCA -> GTTAGGGTTGGATCCGAACACCAC
GGGCCGGCTAGTTCAGGGTTCATT -> GGCCGGCTAGTTCAGGGTTCATTC
ATCATATTGATCCTGGCTTTACGC -> TCATATTGATCCTGGCTTTACGCG
GAAGACCCGGTCGTGTGGCCGGCA -> AAGACCCGGTCGTGTGGCCGGCAA
TTGTTGTTGCGGTCACTCGTCTCC -> TGTTGTTGCGGTCACTCGTCTCCT
GTGGGAACATCAGACAGAAACTCG -> TGGGAACATCAGACAGAAACTCGG
AGCCGTCGGAGATGCCGGTCCCTC -> GCCGTCGGAGATGCCGGTCCCTCA
AGAATTGAGAGCATGTCGAGAGAT -> GAATTGAGAGCATGTCGAGAGATT
ATACGTGTGTAGGGAACATGCAGC -> TACGTGTGTAGGGAACATGCAGCT
ATGTATGTATAAGTTGCGTCGTCG -> TGTATGTATAAGTTGCGTCGTCGT
GTAACCTAACGGGGCCGGCTAGTT -> TAACCTAACGGGGCCGGCTAGTTC
CCATACGCAATCGAGTTCGTACTG -> CATACGCAATCGAGTTCGTACTGA
ATTGCATCAGACTTACCTGTTATC -> TTGCATCAGACTTACCTGTTATCG
CTGGAGGCCGACGTTTCGCTATGG -> TGGAGGCCGACGTTTCGCTATGGA
GCCTAGACATAGAGACTGACGGAC -> CCTAGACATAGAGACTGACGGACG
TGAACGGTCTTTCCCTATTCCTAA -> GAACGGTCTTTCCCTATTCCTAAG
GGACGGTACCAGCTAGGCAATCGG -> GACGGTACCAGCTAGGCAATCGGA
GTGCTCGTACCGCCTTAGCGAGCG -> TGCTCGTACCGCCTTAGCGAGCGG
TAGATCGTTGTGAACTGAGCAGCT -> AGATCGTTGTGAACTGAGCAGCTG
GAAGATTTCTGCCCTAATTGACTA -> AAGATTTCTGCCCTAATTGACTAG
TAGAGAAGGGTGTGGTCGAACAAG -> AGAGAAGGGTGTGGTCGAACAAGA
GGGCAAGTCTTCCTAGATGTCGGA -> GGCAAGTCTTCCTAGATGTCGGAT
GAATGAAGCGCGTGTATGTAACGT -> AATGAAGCGCGTGTATGTAACGTA
ACGGTACCAGCTAGGCAATCGGAC -> CGGTACCAGCTAGGCAATCGGACA
TTATCCCACCAATCACAGCATGTT -> TATCCCACCAATCACAGCATGTTC
AAACATGCCGACTACTCATCTTGA -> AACATGCCGACTACTCATCTTGAT
CGTGCCTCCCGGGGCCCCTGAGAC -> GTGCCTCCCGGGGCCCCTGAGACT
TTTCTGCCCTAATTGACTAGAAAT -> TTCTGCCCTAATTGACTAGAAATT
GCACGTGCCCAATTAGATGATCAC -> CACGTGCCCAATTAGATGATCACT
GGGGTAGCCGAAAGCCCGACGGCC -> GGGTAGCCGAAAGCCCGACGGCCA
CGGATGTTCAATGGTGAGCGTTAT -> GGATGTTCAATGGTGAGCGTTATG
TGCGGCTGCGGCCAAGGCTCTGTT -> GCGGCTGCGGCCAAGGCTCTGTTA
GGCTGCGGCCAAGGCTCTGTTAGG -> GCTGCGGCCAAGGCTCTGTTAGGG
TTATAATAAGCGAAATCGCGCCCT -> TATAATAAGCGAAATCGCGCCCTC
GGTTTAGCCTACCATCATGCAGCC -> GTTTAGCCTACCATCATGCAGCCT
GTCAACGTCCCTTACAGTTCTCCA -> TCAACGTCCCTTACAGTTCTCCAC
GATCTAGCGTCTAGAGCACAACTT -> ATCTAGCGTCTAGAGCACAACTTT
GGCCATGTAGCGTAGTACAGTATT -> GCCATGTAGCGTAGTACAGTATTG
ACCCGGTCGTGTGGCCGGCAACTA -> CCCGGTCGTGTGGCCGGCAACTAT
GTCTAGAGCACAACTTTTCACCGG -> TCTAGAGCACAACTTTTCACCGGG
CTCCGGCTTTGCTGATACATGCGG -> TCCGGCTTTGCTGATACATGCGGG
CACCGCTAAGTGGCCAATCTGAGT -> ACCGCTAAGTGGCCAATCTGAGTC
AACGCACAGTTTGTTTACCATGGT -> ACGCACAGTTTGTTTACCATGGTT
GTCACGCCGCATTGCATCAGACTT -> TCACGCCGCATTGCATCAGACTTA
TGCGGGGGTTTTCACCAGACCTGT -> GCGGGGGTTTTCACCAGACCTGTT
TGGGTAACCTAACGGGGCCGGCTA -> GGGTAACCTAACGGGGCCGGCTAG
CCAACGCACAGTTTGTTTACCATG -> CAACGCACAGTTTGTTTACCATGG
TCTAGATTACAAGTTCCACGGGGG -> CTAGATTACAAGTTCCACGGGGGT
ATTTCTGCCCTAATTGACTAGAAA -> TTTCTGCCCTAATTGACTAGAAAT
AGCATGTCGAGAGATTAAAAACAC -> GCATGTCGAGAGATTAAAAACACC
AGCGTACAGAAAATCAAGCATAGA -> GCGTACAGAAAATCAAGCATAGAG
TGATACATGCGGGCTTTATCAGAC -> GATACATGCGGGCTTTATCAGACC
CGCTAAGTGGCCAATCTGAGTCGT -> GCTAAGTGGCCAATCTGAGTCGTC
CCTACCATCATGCAGCCTACTGAT -> CTACCATCATGCAGCCTACTGATG
TTCCTAAGCCGGATGTTCAATGGT -> TCCTAAGCCGGATGTTCAATGGTG
TAACTAAGGTGGGAACATCAGACA -> AACTAAGGTGGGAACATCAGACAG
TGTAACGTAGACGCACAGACATTA -> GTAACGTAGACGCACAGACATTAG
ATGGGCGGGTAGAATTGAGAGCAT -> TGGGCGGGTAGAATTGAGAGCATG
ATGCCGACTACTCATCTTGATTAT -> TGCCGACTACTCATCTTGATTATC
AGATTGAGTTGCGGGGGTTTTCAC -> GATTGAGTTGCGGGGGTTTTCACC
GACAGTGCCAATTCGATTCGATAA -> ACAGTGCCAATTCGATTCGATAAC
CTACCATCATGCAGCCTACTGATG -> TACCATCATGCAGCCTACTGATGT
ACTCGAGGAGATAGCCTCGGTTTG -> CTCGAGGAGATAGCCTCGGTTTGC
GTCTTCCTAGATGTCGGATCTTTC -> TCTTCCTAGATGTCGGATCTTTCA
AGTGCTATGTCGACAAGGGCTTCT -> GTGCTATGTCGACAAGGGCTTCTA
CATAGAGACTGACGGACGATAGGC -> ATAGAGACTGACGGACGATAGGCC
TCGTTTGCAGCCGTCGGAGATGCC -> CGTTTGCAGCCGTCGGAGATGCCG
CATGCGGGCTTTATCAGACCTGAC -> ATGCGGGCTTTATCAGACCTGACC
GAGATTAAAAACACCGCCCGTAAG -> AGATTAAAAACACCGCCCGTAAGA
CAATCATATTGATCCTGGCTTTAC -> AATCATATTGATCCTGGCTTTACG
TAGGGAACATGCAGCTGAAGCGTC -> AGGGAACATGCAGCTGAAGCGTCG
CACTCAGTAGGTTTAGCCTACCAT -> ACTCAGTAGGTTTAGCCTACCATC
GGTTCGACTTTATTCAAGTGAGGG -> GTTCGACTTTATTCAAGTGAGGGC
GAGACCCCAATGAAATGTATGTAT -> AGACCCCAATGAAATGTATGTATA
GTTGCGTCGTCGTGGGTGCTCGTA -> TTGCGTCGTCGTGGGTGCTCGTAC
TATAAGTTGCGTCGTCGTGGGTGC -> ATAAGTTGCGTCGTCGTGGGTGCT
ACAGTTCTCCACCTTGCGAGCGAT -> CAGTTCTCCACCTTGCGAGCGATT
ACCGCTAAGTGGCCAATCTGAGTC -> CCGCTAAGTGGCCAATCTGAGTCG
GGAAATGGGCGGGTAGAATTGAGA -> GAAATGGGCGGGTAGAATTGAGAG
GTACCAGCTAGGCAATCGGACACG -> TACCAGCTAGGCAATCGGACACGA
GCACAGACATTAGGGTTCATGGTC -> CACAGACATTAGGGTTCATGGTCT
GGCTACTCCAACGCACAGTTTGTT -> GCTACTCCAACGCACAGTTTGTTT
GAAATCGCGCCCTCCCGTAACACA -> AAATCGCGCCCTCCCGTAACACAT
CCGCTGGAGGCCGACGTTTCGCTA -> CGCTGGAGGCCGACGTTTCGCTAT
AGCACAACTTTTCACCGGGACTCC -> GCACAACTTTTCACCGGGACTCCG
CACCCGCGGGAAACTCTAGTTTGC -> ACCCGCGGGAAACTCTAGTTTGCC
TCACTCAGTAGGTTTAGCCTACCA -> CACTCAGTAGGTTTAGCCTACCAT
CATGTCGAGAGATTAAAAACACCG -> ATGTCGAGAGATTAAAAACACCGC
TCTCGGGTTCGACTTTATTCAAGT -> CTCGGGTTCGACTTTATTCAAGTG
TCCAGTGCCTGCCTAGACATAGAG -> CCAGTGCCTGCCTAGACATAGAGA
TCAGACAGAAACTCGGATGAACCG -> CAGACAGAAACTCGGATGAACCGC
GGAGCACACCATTTTCAATCATAT -> GAGCACACCATTTTCAATCATATT
CGCAATCGAGTTCGTACTGAACAG -> GCAATCGAGTTCGTACTGAACAGT
CCACCTTGCGAGCGATTACCTAAT -> CACCTTGCGAGCGATTACCTAATA
AGTTCCACGGGGGTGGATCCCGGG -> GTTCCACGGGGGTGGATCCCGGGC
CGTCACGCCGCATTGCATCAGACT -> GTCACGCCGCATTGCATCAGACTT
TCACCGGGACTCCGGCTTTGCTGA -> CACCGGGACTCCGGCTTTGCTGAT
AGTGCCTGCCTAGACATAGAGACT -> GTGCCTGCCTAGACATAGAGACTG
AACAAAGACATTTAAAGACTGCGA -> ACAAAGACATTTAAAGACTGCGAT
TGCGTCGTCGTGGGTGCTCGTACC -> GCGTCGTCGTGGGTGCTCGTACCG
TCCTAGATGTCGGATCTTTCAGAA -> CCTAGATGTCGGATCTTTCAGAAA
TTATCTGCGGCGTCGGGGGAGGCT -> TATCTGCGGCGTCGGGGGAGGCTT
GCTTTATCAGACCTGACCTAAACC -> CTTTATCAGACCTGACCTAAACCG
TGCATGCTCTGACAGCCCAATCTA -> GCATGCTCTGACAGCCCAATCTAG
GCTACAGCGAGCGGAAATGGGCGG -> CTACAGCGAGCGGAAATGGGCGGG
TGTGGTGTCCGCCAGACGCTAAAC -> GTGGTGTCCGCCAGACGCTAAACA
CGATCACGCGAGAAACGTTAAATT -> GATCACGCGAGAAACGTTAAATTA
ATTGAGTTGCGGGGGTTTTCACCA -> TTGAGTTGCGGGGGTTTTCACCAG
CGGATGAACCGCTGGAGGCCGACG -> GGATGAACCGCTGGAGGCCGACGT
TGGGACGGTACCAGCTAGGCAATC -> GGGACGGTACCAGCTAGGCAATCG
TCCCTATTCCTAAGCCGGATGTTC -> CCCTATTCCTAAGCCGGATGTTCA
TCATATTGATCCTGGCTTTACGCG -> CATATTGATCCTGGCTTTACGCGC
GCACAGTTTGTTTACCATGGTTCG -> CACAGTTTGTTTACCATGGTTCGG
AGCCAATTGGAGCACACCATTTTC -> GCCAATTGGAGCACACCATTTTCA
GGTGGCGGATGTTAGACTCTAGAT -> GTGGCGGATGTTAGACTCTAGATT
CAATCGAGTTCGTACTGAACAGTT -> AATCGAGTTCGTACTGAACAGTTA
GGCTTCTAACGCTGGCTTAACTCC -> GCTTCTAACGCTGGCTTAACTCCT
ATCATGCAGCCTACTGATGTAGAG -> TCATGCAGCCTACTGATGTAGAGG
CTTGCACGTGCCCAATTAGATGAT -> TTGCACGTGCCCAATTAGATGATC
GTCTCCTCTCGGGTTCGACTTTAT -> TCTCCTCTCGGGTTCGACTTTATT
CTATTCCTAAGCCGGATGTTCAAT -> TATTCCTAAGCCGGATGTTCAATG
CCACACGGAGTTGACCCAATGAGA -> CACACGGAGTTGACCCAATGAGAG
GTGCCAATTCGATTCGATAACTAA -> TGCCAATTCGATTCGATAACTAAG
ATTGCGGCTGCGGCCAAGGCTCTG -> TTGCGGCTGCGGCCAAGGCTCTGT
TCTGAGTCGTCGTGTATCACTCAG -> CTGAGTCGTCGTGTATCACTCAGT
AGTCTTCCTAGATGTCGGATCTTT -> GTCTTCCTAGATGTCGGATCTTTC
TCTTGGGGAAATTGCGGCTGCGGC -> CTTGGGGAAATTGCGGCTGCGGCC
TGCCGACTACTCATCTTGATTATC -> GCCGACTACTCATCTTGATTATCT
AATGGTGAGCGTTATGTCAACGTC -> ATGGTGAGCGTTATGTCAACGTCC
GTTCGACTTTATTCAAGTGAGGGC -> TTCGACTTTATTCAAGTGAGGGCC
AAAGCCCGACGGCCACTGTCACCC -> AAGCCCGACGGCCACTGTCACCCT
ATGTAGAGGAGACCCCAATGAAAT -> TGTAGAGGAGACCCCAATGAAATG
AGAAAATCAAGCATAGAGAAGGGT -> GAAAATCAAGCATAGAGAAGGGTG
GGTCTTTATTTTGTTGTTGCGGTC -> GTCTTTATTTTGTTGTTGCGGTCA
CTAGGCAATCGGACACGATCACGC -> TAGGCAATCGGACACGATCACGCG
ACTCTAGTTTGCCCAAGCTCTTGG -> CTCTAGTTTGCCCAAGCTCTTGGG
GCCAAGGCTCTGTTAGGGCTCGAG -> CCAAGGCTCTGTTAGGGCTCGAGG
GTTCAATTCGATCTAGCGTCTAGA -> TTCAATTCGATCTAGCGTCTAGAG
ACCTAATAGTCCGTGAAGGGTCAG -> CCTAATAGTCCGTGAAGGGTCAGT
GCCCTCCCGTAACACATTCAAATA -> CCCTCCCGTAACACATTCAAATAT
GTATGTATAAGTTGCGTCGTCGTG -> TATGTATAAGTTGCGTCGTCGTGG
CAATCACAGCATGTTCAATTCGAT -> AATCACAGCATGTTCAATTCGATC
CAGAAACTCAGTGCCACCCGCGGG -> AGAAACTCAGTGCCACCCGCGGGA
CAGACTTACCTGTTATCGAAGATT -> AGACTTACCTGTTATCGAAGATTG
GTTCATTCGCGTCACGCCGCATTG -> TTCATTCGCGTCACGCCGCATTGC
TTGTGAACTGAGCAGCTGCGCCCG -> TGTGAACTGAGCAGCTGCGCCCGG
CGGCTAGTTCAGGGTTCATTCGCG -> GGCTAGTTCAGGGTTCATTCGCGT
ACTCCTGTGGTGTCCGCCAGACGC -> CTCCTGTGGTGTCCGCCAGACGCT
ATTAGGGTTCATGGTCTTTATTTT -> TTAGGGTTCATGGTCTTTATTTTG
CGCCTTAGCGAGCGGTGGCGGATG -> GCCTTAGCGAGCGGTGGCGGATGT
TAAAGACTGCGATGGAATTATAAT -> AAAGACTGCGATGGAATTATAATA
GGGTGGATCCCGGGCTGCTTAAGA -> GGTGGATCCCGGGCTGCTTAAGAC
TGGTTCGGGTGGCCGTTATCCCAC -> GGTTCGGGTGGCCGTTATCCCACC
TCACGCGAGAAACGTTAAATTACC -> CACGCGAGAAACGTTAAATTACCT
TCGTGGGTGCTCGTACCGCCTTAG -> CGTGGGTGCTCGTACCGCCTTAGC
CCTGTAGGCAGCGTACAGAAAATC -> CTGTAGGCAGCGTACAGAAAATCA
CACGGGGGTGGATCCCGGGCTGCT -> ACGGGGGTGGATCCCGGGCTGCTT
GCCCAATCTAGGCTCTAGGGGGCT -> CCCAATCTAGGCTCTAGGGGGCTA
GAGTTGACCCAATGAGAGCGCCTG -> AGTTGACCCAATGAGAGCGCCTGT
AATATCACCGCTAAGTGGCCAATC -> ATATCACCGCTAAGTGGCCAATCT
AACGTCCCTTACAGTTCTCCACCT -> ACGTCCCTTACAGTTCTCCACCTT
TCCCTTGCACGTGCCCAATTAGAT -> CCCTTGCACGTGCCCAATTAGATG
TATAATAAGCGAAATCGCGCCCTC -> ATAATAAGCGAAATCGCGCCCTCC
CCATCATGCAGCCTACTGATGTAG -> CATCATGCAGCCTACTGATGTAGA
AAGCGTCGGGCCATTTGCTGCATG -> AGCGTCGGGCCATTTGCTGCATGC
CTTCCCATACGCAATCGAGTTCGT -> TTCCCATACGCAATCGAGTTCGTA
ACGTATACGGTAGCTTCCCATACG -> CGTATACGGTAGCTTCCCATACGC
GCCACCCGCGGGAAACTCTAGTTT -> CCACCCGCGGGAAACTCTAGTTTG
CGGCCATGTAGCGTAGTACAGTAT -> GGCCATGTAGCGTAGTACAGTATT
ACGTGTGTAGGGAACATGCAGCTG -> CGTGTGTAGGGAACATGCAGCTGA
GAGCGCGAGTGCTATGTCGACAAG -> AGCGCGAGTGCTATGTCGACAAGG
CTCGTCTCCTCTCGGGTTCGACTT -> TCGTCTCCTCTCGGGTTCGACTTT
AACTCCTGTGGTGTCCGCCAGACG -> ACTCCTGTGGTGTCCGCCAGACGC
TGCCCAATTAGATGATCACTGAAG -> GCCCAATTAGATGATCACTGAAGA
GCATGCTCTGACAGCCCAATCTAG -> CATGCTCTGACAGCCCAATCTAGG
CTAGCGTCTAGAGCACAACTTTTC -> TAGCGTCTAGAGCACAACTTTTCA
CATGTTCAATTCGATCTAGCGTCT -> ATGTTCAATTCGATCTAGCGTCTA
AGCGAGCGGAAATGGGCGGGTAGA -> GCGAGCGGAAATGGGCGGGTAGAA
GCGGCTGCGGCCAAGGCTCTGTTA -> CGGCTGCGGCCAAGGCTCTGTTAG
ATTGTGAAGACCCGGTCGTGTGGC -> TTGTGAAGACCCGGTCGTGTGGCC
GTGGGTGCTCGTACCGCCTTAGCG -> TGGGTGCTCGTACCGCCTTAGCGA
CGGCTGCGGCCAAGGCTCTGTTAG -> GGCTGCGGCCAAGGCTCTGTTAGG
GTAGCTTCCCATACGCAATCGAGT -> TAGCTTCCCATACGCAATCGAGTT
TTTCGCTATGGAAAAAAAGTTGTG -> TTCGCTATGGAAAAAAAGTTGTGT
GACTCGAGGAGATAGCCTCGGTTT -> ACTCGAGGAGATAGCCTCGGTTTG
TTCAATCATATTGATCCTGGCTTT -> TCAATCATATTGATCCTGGCTTTA
AAATCGCGCCCTCCCGTAACACAT -> AATCGCGCCCTCCCGTAACACATT
CCCAAGCTCTTGGGGAAATTGCGG -> CCAAGCTCTTGGGGAAATTGCGGC
CAAGTTCCACGGGGGTGGATCCCG -> AAGTTCCACGGGGGTGGATCCCGG
TCAAGTGAGGGCCTGTGGCTACTC -> CAAGTGAGGGCCTGTGGCTACTCC
ATCCGGGCAAGTCTTCCTAGATGT -> TCCGGGCAAGTCTTCCTAGATGTC
AGAAATTGGACTACACATACGTGT -> GAAATTGGACTACACATACGTGTG
GCTGAAGCGTCGGGCCATTTGCTG -> CTGAAGCGTCGGGCCATTTGCTGC
ATCCCGGGCTGCTTAAGACTCAAT -> TCCCGGGCTGCTTAAGACTCAATC
TGGGAACATCAGACAGAAACTCGG -> GGGAACATCAGACAGAAACTCGGA
GCGAAATCGCGCCCTCCCGTAACA -> CGAAATCGCGCCCTCCCGTAACAC
GCAACTATCCCTTGCACGTGCCCA -> CAACTATCCCTTGCACGTGCCCAA
CTGGATGTGAACGGTCTTTCCCTA -> TGGATGTGAACGGTCTTTCCCTAT
ACAAAGACATTTAAAGACTGCGAT -> CAAAGACATTTAAAGACTGCGATG
TTGGATCCGAACACCACACGGAGT -> TGGATCCGAACACCACACGGAGTT
CGTTATGTCAACGTCCCTTACAGT -> GTTATGTCAACGTCCCTTACAGTT
AATTCCGGCCATGTAGCGTAGTAC -> ATTCCGGCCATGTAGCGTAGTACA
GTATTGTGAAGACCCGGTCGTGTG -> TATTGTGAAGACCCGGTCGTGTGG
ATGTTCAATTCGATCTAGCGTCTA -> TGTTCAATTCGATCTAGCGTCTAG
TATTCAAGTGAGGGCCTGTGGCTA -> ATTCAAGTGAGGGCCTGTGGCTAC
CCGAAAGCCCGACGGCCACTGTCA -> CGAAAGCCCGACGGCCACTGTCAC
TCACCAGACCTGTTAGGGTTGGAT -> CACCAGACCTGTTAGGGTTGGATC
TGAAGGGTCAGTATCGCGGATGAG -> GAAGGGTCAGTATCGCGGATGAGA
AACATGCCGACTACTCATCTTGAT -> ACATGCCGACTACTCATCTTGATT
GGCCCGGGGGTAGCCTCCGTGCCT -> GCCCGGGGGTAGCCTCCGTGCCTC
GCGGCGTCGGGGGAGGCTTTCGTC -> CGGCGTCGGGGGAGGCTTTCGTCG
TAGATGATCACTGAAGAGTTACAG -> AGATGATCACTGAAGAGTTACAGA
CAGAGACAGTGCCAATTCGATTCG -> AGAGACAGTGCCAATTCGATTCGA
GTGGATCCCGGGCTGCTTAAGACT -> TGGATCCCGGGCTGCTTAAGACTC
TGGATGTGAACGGTCTTTCCCTAT -> GGATGTGAACGGTCTTTCCCTATT
GAAAAAAAGTTGTGTTCTGGATGT -> AAAAAAAGTTGTGTTCTGGATGTG
GAAATTGCGGCTGCGGCCAAGGCT -> AAATTGCGGCTGCGGCCAAGGCTC
TGTCCGCCAGACGCTAAACATGCC -> GTCCGCCAGACGCTAAACATGCCG
GCCCAATTAGATGATCACTGAAGA -> CCCAATTAGATGATCACTGAAGAG
ATTTGCTGCATGCTCTGACAGCCC -> TTTGCTGCATGCTCTGACAGCCCA
CGAGAGATTAAAAACACCGCCCGT -> GAGAGATTAAAAACACCGCCCGTA
CGTGTATCACTCAGTAGGTTTAGC -> GTGTATCACTCAGTAGGTTTAGCC
GTAGTACAGTATTGTGAAGACCCG -> TAGTACAGTATTGTGAAGACCCGG
CAGAAAATCAAGCATAGAGAAGGG -> AGAAAATCAAGCATAGAGAAGGGT
GGGAGGCTTTCGTCGAATGAAGCG -> GGAGGCTTTCGTCGAATGAAGCGC
CCCTCCCGTCCAGTGCCTGCCTAG -> CCTCCCGTCCAGTGCCTGCCTAGA
ATGAAGCGCGTGTATGTAACGTAG -> TGAAGCGCGTGTATGTAACGTAGA
GTCGAACAAGATGGCCACGTATAC -> TCGAACAAGATGGCCACGTATACG
TACTCATCTTGATTATCTGCGGCG -> ACTCATCTTGATTATCTGCGGCGT
AGTAGGTTTAGCCTACCATCATGC -> GTAGGTTTAGCCTACCATCATGCA
CAGATCCGGGCAAGTCTTCCTAGA -> AGATCCGGGCAAGTCTTCCTAGAT
TCGTCGTGGGTGCTCGTACCGCCT -> CGTCGTGGGTGCTCGTACCGCCTT
CGACTTTATTCAAGTGAGGGCCTG -> GACTTTATTCAAGTGAGGGCCTGT
GAGCACACCATTTTCAATCATATT -> AGCACACCATTTTCAATCATATTG
CTAGAGCACAACTTTTCACCGGGA -> TAGAGCACAACTTTTCACCGGGAC
CGTGGGTGCTCGTACCGCCTTAGC -> GTGGGTGCTCGTACCGCCTTAGCG
AACGGGGCCGGCTAGTTCAGGGTT -> ACGGGGCCGGCTAGTTCAGGGTTC
CGCCTGTAGGCAGCGTACAGAAAA -> GCCTGTAGGCAGCGTACAGAAAAT
CGTCGGGCCATTTGCTGCATGCTC -> GTCGGGCCATTTGCTGCATGCTCT
TAGGGTTGGATCCGAACACCACAC -> AGGGTTGGATCCGAACACCACACG
CAATGTGAAACTTGAAGATTTCTG -> AATGTGAAACTTGAAGATTTCTGC
CAACAAAGACATTTAAAGACTGCG -> AACAAAGACATTTAAAGACTGCGA
ACCTAAACCGAATTCAATTAGGCG -> CCTAAACCGAATTCAATTAGGCGC
GCACACCATTTTCAATCATATTGA -> CACACCATTTTCAATCATATTGAT
AGATGGCCACGTATACGGTAGCTT -> GATGGCCACGTATACGGTAGCTTC
AATAAGCGAAATCGCGCCCTCCCG -> ATAAGCGAAATCGCGCCCTCCCGT
GGGGCTAGCGCATACCATACTTCA -> GGGCTAGCGCATACCATACTTCAG
ACTGAACAGTTATCGTTTGCAGCC -> CTGAACAGTTATCGTTTGCAGCCG
GATGTAGAGGAGACCCCAATGAAA -> ATGTAGAGGAGACCCCAATGAAAT
ACCAGCTAGGCAATCGGACACGAT -> CCAGCTAGGCAATCGGACACGATC
GGTTTTCACCAGACCTGTTAGGGT -> GTTTTCACCAGACCTGTTAGGGTT
TCGAGGTTGAGCGAGCGCGAGTGC -> CGAGGTTGAGCGAGCGCGAGTGCT
GTCGGAGATGCCGGTCCCTCAGAG -> TCGGAGATGCCGGTCCCTCAGAGA
TCGTGTGGCCGGCAACTATCCCTT -> CGTGTGGCCGGCAACTATCCCTTG
GGTCAGTATCGCGGATGAGAACAA -> GTCAGTATCGCGGATGAGAACAAT
TGGTGAGCGTTATGTCAACGTCCC -> GGTGAGCGTTATGTCAACGTCCCT
AGACAGTGCCAATTCGATTCGATA -> GACAGTGCCAATTCGATTCGATAA
GACAGCCCAATCTAGGCTCTAGGG -> ACAGCCCAATCTAGGCTCTAGGGG
ACGGACGATAGGCCTGTGGCCTGG -> CGGACGATAGGCCTGTGGCCTGGG
TCGCGTCACGCCGCATTGCATCAG -> CGCGTCACGCCGCATTGCATCAGA
CAGTAGGTTTAGCCTACCATCATG -> AGTAGGTTTAGCCTACCATCATGC
ATGTCAACGTCCCTTACAGTTCTC -> TGTCAACGTCCCTTACAGTTCTCC
GATGGGACGGTACCAGCTAGGCAA -> ATGGGACGGTACCAGCTAGGCAAT
TGGACTACACATACGTGTGTAGGG -> GGACTACACATACGTGTGTAGGGA
CAGCCAATTGGAGCACACCATTTT -> AGCCAATTGGAGCACACCATTTTC
TATCTGCGGCGTCGGGGGAGGCTT -> ATCTGCGGCGTCGGGGGAGGCTTT
GAGCGAGCGCGAGTGCTATGTCGA -> AGCGAGCGCGAGTGCTATGTCGAC
AATGAAATGTATGTATAAGTTGCG -> ATGAAATGTATGTATAAGTTGCGT
CCTAGACATAGAGACTGACGGACG -> CTAGACATAGAGACTGACGGACGA
TCAGAGACAGTGCCAATTCGATTC -> CAGAGACAGTGCCAATTCGATTCG
CCGCATTGCATCAGACTTACCTGT -> CGCATTGCATCAGACTTACCTGTT
GTCGTGGGTGCTCGTACCGCCTTA -> TCGTGGGTGCTCGTACCGCCTTAG
TGGCTTTACGCGCATTAGATCGTT -> GGCTTTACGCGCATTAGATCGTTG
ATCAGACAGAAACTCGGATGAACC -> TCAGACAGAAACTCGGATGAACCG
TCGAAGATTGAGTTGCGGGGGTTT -> CGAAGATTGAGTTGCGGGGGTTTT
GATTATCTGCGGCGTCGGGGGAGG -> ATTATCTGCGGCGTCGGGGGAGGC
ATGATCACTGAAGAGTTACAGATC -> TGATCACTGAAGAGTTACAGATCC
AAATTGGACTACACATACGTGTGT -> AATTGGACTACACATACGTGTGTA
AGAGACAGTGCCAATTCGATTCGA -> GAGACAGTGCCAATTCGATTCGAT
ATTAGATCGTTGTGAACTGAGCAG -> TTAGATCGTTGTGAACTGAGCAGC
CCTGACCTAAACCGAATTCAATTA -> CTGACCTAAACCGAATTCAATTAG
GTGAAACTTGAAGATTTCTGCCCT -> TGAAACTTGAAGATTTCTGCCCTA
ATTCCTAAGCCGGATGTTCAATGG -> TTCCTAAGCCGGATGTTCAATGGT
GGCTACAGCGAGCGGAAATGGGCG -> GCTACAGCGAGCGGAAATGGGCGG
TGTTCTGGATGTGAACGGTCTTTC -> GTTCTGGATGTGAACGGTCTTTCC
TTCAAGTGAGGGCCTGTGGCTACT -> TCAAGTGAGGGCCTGTGGCTACTC
TTTACGCGCATTAGATCGTTGTGA -> TTACGCGCATTAGATCGTTGTGAA
TAGAAATTGGACTACACATACGTG -> AGAAATTGGACTACACATACGTGT
ATTCCGGCCATGTAGCGTAGTACA -> TTCCGGCCATGTAGCGTAGTACAG
GTTCAGGGTTCATTCGCGTCACGC -> TTCAGGGTTCATTCGCGTCACGCC
CTGGCTTAACTCCTGTGGTGTCCG -> TGGCTTAACTCCTGTGGTGTCCGC
CGAGAAACGTTAAATTACCTGGGG -> GAGAAACGTTAAATTACCTGGGGC
GAAGGGTGTGGTCGAACAAGATGG -> AAGGGTGTGGTCGAACAAGATGGC
GGCAAGTCTTCCTAGATGTCGGAT -> GCAAGTCTTCCTAGATGTCGGATC
AAGGGTGTGGTCGAACAAGATGGC -> AGGGTGTGGTCGAACAAGATGGCC
CGGTGGCGGATGTTAGACTCTAGA -> GGTGGCGGATGTTAGACTCTAGAT
GGTAGCCTCCGTGCCTCCCGGGGC -> GTAGCCTCCGTGCCTCCCGGGGCC
AGGAGACCCCAATGAAATGTATGT -> GGAGACCCCAATGAAATGTATGTA
AACTTGAAGATTTCTGCCCTAATT -> ACTTGAAGATTTCTGCCCTAATTG
CTCTTGGGGAAATTGCGGCTGCGG -> TCTTGGGGAAATTGCGGCTGCGGC
AAGAGTTACAGATCCGGGCAAGTC -> AGAGTTACAGATCCGGGCAAGTCT
AATGAGAGCGCCTGTAGGCAGCGT -> ATGAGAGCGCCTGTAGGCAGCGTA
TTTCAATCATATTGATCCTGGCTT -> TTCAATCATATTGATCCTGGCTTT
ATCCCACCAATCACAGCATGTTCA -> TCCCACCAATCACAGCATGTTCAA
GAAATTGGACTACACATACGTGTG -> AAATTGGACTACACATACGTGTGT
ACCAATCACAGCATGTTCAATTCG -> CCAATCACAGCATGTTCAATTCGA
GATTACCTAATAGTCCGTGAAGGG -> ATTACCTAATAGTCCGTGAAGGGT
TGTTAGGGCTCGAGGTTGAGCGAG -> GTTAGGGCTCGAGGTTGAGCGAGC
GGCCCCTGAGACTCGAGGAGATAG -> GCCCCTGAGACTCGAGGAGATAGC
AGCCTCGGTTTGCGGAGGCTGGAA -> GCCTCGGTTTGCGGAGGCTGGAAA
AAGGGTCAGTATCGCGGATGAGAA -> AGGGTCAGTATCGCGGATGAGAAC
TTGACTAGAAATTGGACTACACAT -> TGACTAGAAATTGGACTACACATA
GTTTGCGGAGGCTGGAAAATTCCG -> TTTGCGGAGGCTGGAAAATTCCGG
CTGTGGCCTGGGTAACCTAACGGG -> TGTGGCCTGGGTAACCTAACGGGG
AGACATTAGGGTTCATGGTCTTTA -> GACATTAGGGTTCATGGTCTTTAT
TCTGTTAGGGCTCGAGGTTGAGCG -> CTGTTAGGGCTCGAGGTTGAGCGA
ACTCCGGCTTTGCTGATACATGCG -> CTCCGGCTTTGCTGATACATGCGG
AACTCAGTGCCACCCGCGGGAAAC -> ACTCAGTGCCACCCGCGGGAAACT
TCGACTTTATTCAAGTGAGGGCCT -> CGACTTTATTCAAGTGAGGGCCTG
TCGGGGGAGGCTTTCGTCGAATGA -> CGGGGGAGGCTTTCGTCGAATGAA
TTAGATCGTTGTGAACTGAGCAGC -> TAGATCGTTGTGAACTGAGCAGCT
CTGTTAGGGCTCGAGGTTGAGCGA -> TGTTAGGGCTCGAGGTTGAGCGAG
CAGACCTGACCTAAACCGAATTCA -> AGACCTGACCTAAACCGAATTCAA
GGGGGAGGCTTTCGTCGAATGAAG -> GGGGAGGCTTTCGTCGAATGAAGC
GGGGGTTTTCACCAGACCTGTTAG -> GGGGTTTTCACCAGACCTGTTAGG
TATACGGTAGCTTCCCATACGCAA -> ATACGGTAGCTTCCCATACGCAAT
ATCGTTTGCAGCCGTCGGAGATGC -> TCGTTTGCAGCCGTCGGAGATGCC
AGGCCTGTGGCCTGGGTAACCTAA -> GGCCTGTGGCCTGGGTAACCTAAC
GGAGACCCCAATGAAATGTATGTA -> GAGACCCCAATGAAATGTATGTAT
GCCTGGGTAACCTAACGGGGCCGG -> CCTGGGTAACCTAACGGGGCCGGC
ACTTGAAGATTTCTGCCCTAATTG -> CTTGAAGATTTCTGCCCTAATTGA
GATCACTGAAGAGTTACAGATCCG -> ATCACTGAAGAGTTACAGATCCGG
AATCAAGCATAGAGAAGGGTGTGG -> ATCAAGCATAGAGAAGGGTGTGGT
GACAGAAACTCGGATGAACCGCTG -> ACAGAAACTCGGATGAACCGCTGG
AAACTCAGTGCCACCCGCGGGAAA -> AACTCAGTGCCACCCGCGGGAAAC
GGCCGGCTAGTTCAGGGTTCATTC -> GCCGGCTAGTTCAGGGTTCATTCG
ATAATAAGCGAAATCGCGCCCTCC -> TAATAAGCGAAATCGCGCCCTCCC
GCTACTCCAACGCACAGTTTGTTT -> CTACTCCAACGCACAGTTTGTTTA
CGCACAGTTTGTTTACCATGGTTC -> GCACAGTTTGTTTACCATGGTTCG
AGTTGTGTTCTGGATGTGAACGGT -> GTTGTGTTCTGGATGTGAACGGTC
TTCGATAACTAAGGTGGGAACATC -> TCGATAACTAAGGTGGGAACATCA
TCCGTGCCTCCCGGGGCCCCTGAG -> CCGTGCCTCCCGGGGCCCCTGAGA
TAGCCTACCATCATGCAGCCTACT -> AGCCTACCATCATGCAGCCTACTG
TTCGATCTAGCGTCTAGAGCACAA -> TCGATCTAGCGTCTAGAGCACAAC
CAATTAGATGATCACTGAAGAGTT -> AATTAGATGATCACTGAAGAGTTA
CCGGGGGTAGCCTCCGTGCCTCCC -> CGGGGGTAGCCTCCGTGCCTCCCG
AGATGCCGGTCCCTCAGAGACAGT -> GATGCCGGTCCCTCAGAGACAGTG
CGTACTGAACAGTTATCGTTTGCA -> GTACTGAACAGTTATCGTTTGCAG
CGAGCGCGAGTGCTATGTCGACAA -> GAGCGCGAGTGCTATGTCGACAAG
GGCTGGAAAATTCCGGCCATGTAG -> GCTGGAAAATTCCGGCCATGTAGC
CATACGTGTGTAGGGAACATGCAG -> ATACGTGTGTAGGGAACATGCAGC
CGTCGTCGTGGGTGCTCGTACCGC -> GTCGTCGTGGGTGCTCGTACCGCC
TCCCTCAGAGACAGTGCCAATTCG -> CCCTCAGAGACAGTGCCAATTCGA
CGCCCGTAAGATGGGACGGTACCA -> GCCCGTAAGATGGGACGGTACCAG
GGCCGACGTTTCGCTATGGAAAAA -> GCCGACGTTTCGCTATGGAAAAAA
CCGTCGGAGATGCCGGTCCCTCAG -> CGTCGGAGATGCCGGTCCCTCAGA
GCCGACGTTTCGCTATGGAAAAAA -> CCGACGTTTCGCTATGGAAAAAAA
CTAGTTTGCCCAAGCTCTTGGGGA -> TAGTTTGCCCAAGCTCTTGGGGAA
AAGCGAAATCGCGCCCTCCCGTAA -> AGCGAAATCGCGCCCTCCCGTAAC
GACACGATCACGCGAGAAACGTTA -> ACACGATCACGCGAGAAACGTTAA
CCTAATTGACTAGAAATTGGACTA -> CTAATTGACTAGAAATTGGACTAC
GAGCATGTCGAGAGATTAAAAACA -> AGCATGTCGAGAGATTAAAAACAC
ACTTTATTCAAGTGAGGGCCTGTG -> CTTTATTCAAGTGAGGGCCTGTGG
CACAGCATGTTCAATTCGATCTAG -> ACAGCATGTTCAATTCGATCTAGC
TATGTATAAGTTGCGTCGTCGTGG -> ATGTATAAGTTGCGTCGTCGTGGG
CCCGTCCAGTGCCTGCCTAGACAT -> CCGTCCAGTGCCTGCCTAGACATA
CTACAGCGAGCGGAAATGGGCGGG -> TACAGCGAGCGGAAATGGGCGGGT
CGGCAACTATCCCTTGCACGTGCC -> GGCAACTATCCCTTGCACGTGCCC
GGTACCAGCTAGGCAATCGGACAC -> GTACCAGCTAGGCAATCGGACACG
TACCTGTTATCGAAGATTGAGTTG -> ACCTGTTATCGAAGATTGAGTTGC
GGCCGGCAACTATCCCTTGCACGT -> GCCGGCAACTATCCCTTGCACGTG
AGAGACTGACGGACGATAGGCCTG -> GAGACTGACGGACGATAGGCCTGT
GCGGGCTTTATCAGACCTGACCTA -> CGGGCTTTATCAGACCTGACCTAA
GCCAATTGGAGCACACCATTTTCA -> CCAATTGGAGCACACCATTTTCAA
CTATCCCTTGCACGTGCCCAATTA -> TATCCCTTGCACGTGCCCAATTAG
TCCGGGCAAGTCTTCCTAGATGTC -> CCGGGCAAGTCTTCCTAGATGTCG
AGACAGAAACTCGGATGAACCGCT -> GACAGAAACTCGGATGAACCGCTG
GTTTTCACCAGACCTGTTAGGGTT -> TTTTCACCAGACCTGTTAGGGTTG
GTATGTAACGTAGACGCACAGACA -> TATGTAACGTAGACGCACAGACAT
AGAGCACAACTTTTCACCGGGACT -> GAGCACAACTTTTCACCGGGACTC
CCGGCTTTGCTGATACATGCGGGC -> CGGCTTTGCTGATACATGCGGGCT
AGACCCGGTCGTGTGGCCGGCAAC -> GACCCGGTCGTGTGGCCGGCAACT
GGCTTTGCTGATACATGCGGGCTT -> GCTTTGCTGATACATGCGGGCTTT
CATGCTCTGACAGCCCAATCTAGG -> ATGCTCTGACAGCCCAATCTAGGC
TCTAACGCTGGCTTAACTCCTGTG -> CTAACGCTGGCTTAACTCCTGTGG
GAAACTTGAAGATTTCTGCCCTAA -> AAACTTGAAGATTTCTGCCCTAAT
CGGGCCATTTGCTGCATGCTCTGA -> GGGCCATTTGCTGCATGCTCTGAC
AATCTAGGCTCTAGGGGGCTAGCG -> ATCTAGGCTCTAGGGGGCTAGCGC
CCGTGCCTCCCGGGGCCCCTGAGA -> CGTGCCTCCCGGGGCCCCTGAGAC
CTGGAAAATTCCGGCCATGTAGCG -> TGGAAAATTCCGGCCATGTAGCGT
AGCTGAAGCGTCGGGCCATTTGCT -> GCTGAAGCGTCGGGCCATTTGCTG
TACCAGCTAGGCAATCGGACACGA -> ACCAGCTAGGCAATCGGACACGAT
GCGATGGAATTATAATAAGCGAAA -> CGATGGAATTATAATAAGCGAAAT
GGCAATCGGACACGATCACGCGAG -> GCAATCGGACACGATCACGCGAGA
ATGCTCTGACAGCCCAATCTAGGC -> TGCTCTGACAGCCCAATCTAGGCT
CACATTCAAATATCACCGCTAAGT -> ACATTCAAATATCACCGCTAAGTG
ACACCGCCCGTAAGATGGGACGGT -> CACCGCCCGTAAGATGGGACGGTA
AACTTTTCACCGGGACTCCGGCTT -> ACTTTTCACCGGGACTCCGGCTTT
CAGCGTACAGAAAATCAAGCATAG -> AGCGTACAGAAAATCAAGCATAGA
ATGTAGCGTAGTACAGTATTGTGA -> TGTAGCGTAGTACAGTATTGTGAA
CGATTCGATAACTAAGGTGGGAAC -> GATTCGATAACTAAGGTGGGAACA
TTCATGGTCTTTATTTTGTTGTTG -> TCATGGTCTTTATTTTGTTGTTGC
CATACGCAATCGAGTTCGTACTGA -> ATACGCAATCGAGTTCGTACTGAA
ACATGCCGACTACTCATCTTGATT -> CATGCCGACTACTCATCTTGATTA
GGGAACATCAGACAGAAACTCGGA -> GGAACATCAGACAGAAACTCGGAT
TGCCCTAATTGACTAGAAATTGGA -> GCCCTAATTGACTAGAAATTGGAC
TGGCTACTCCAACGCACAGTTTGT -> GGCTACTCCAACGCACAGTTTGTT
GGGTGGCCGTTATCCCACCAATCA -> GGTGGCCGTTATCCCACCAATCAC
GGAGTTGACCCAATGAGAGCGCCT -> GAGTTGACCCAATGAGAGCGCCTG
TTCGACTTTATTCAAGTGAGGGCC -> TCGACTTTATTCAAGTGAGGGCCT
TACTGAACAGTTATCGTTTGCAGC -> ACTGAACAGTTATCGTTTGCAGCC
ATAAGCGAAATCGCGCCCTCCCGT -> TAAGCGAAATCGCGCCCTCCCGTA
TAGGCCTGTGGCCTGGGTAACCTA -> AGGCCTGTGGCCTGGGTAACCTAA
GCTTATGGGGGTAGCCGAAAGCCC -> CTTATGGGGGTAGCCGAAAGCCCG
CTCGGTTTGCGGAGGCTGGAAAAT -> TCGGTTTGCGGAGGCTGGAAAATT
CTCTGACAGCCCAATCTAGGCTCT -> TCTGACAGCCCAATCTAGGCTCTA
CTATGTCGACAAGGGCTTCTAACG -> TATGTCGACAAGGGCTTCTAACGC
ATTCAATTAGGCGCAACAAAGACA -> TTCAATTAGGCGCAACAAAGACAT
TTATTTTGTTGTTGCGGTCACTCG -> TATTTTGTTGTTGCGGTCACTCGT
CGAATGAAGCGCGTGTATGTAACG -> GAATGAAGCGCGTGTATGTAACGT
TAGTTCAGGGTTCATTCGCGTCAC -> AGTTCAGGGTTCATTCGCGTCACG
AGCATGTTCAATTCGATCTAGCGT -> GCATGTTCAATTCGATCTAGCGTC
CACATACGTGTGTAGGGAACATGC -> ACATACGTGTGTAGGGAACATGCA
CGGCCACTGTCACCCTCCCGTCCA -> GGCCACTGTCACCCTCCCGTCCAG
GTTATGTCAACGTCCCTTACAGTT -> TTATGTCAACGTCCCTTACAGTTC
AACCGAATTCAATTAGGCGCAACA -> ACCGAATTCAATTAGGCGCAACAA
CAGCCCAATCTAGGCTCTAGGGGG -> AGCCCAATCTAGGCTCTAGGGGGC
CGGGAAACTCTAGTTTGCCCAAGC -> GGGAAACTCTAGTTTGCCCAAGCT
CTTGATTATCTGCGGCGTCGGGGG -> TTGATTATCTGCGGCGTCGGGGGA
GGGTGCTCGTACCGCCTTAGCGAG -> GGTGCTCGTACCGCCTTAGCGAGC
CCTGAGACTCGAGGAGATAGCCTC -> CTGAGACTCGAGGAGATAGCCTCG
CGCTGGCTTAACTCCTGTGGTGTC -> GCTGGCTTAACTCCTGTGGTGTCC
TGCGGAGGCTGGAAAATTCCGGCC -> GCGGAGGCTGGAAAATTCCGGCCA
ATCCGAACACCACACGGAGTTGAC -> TCCGAACACCACACGGAGTTGACC
CTTTATTTTGTTGTTGCGGTCACT -> TTTATTTTGTTGTTGCGGTCACTC
AAGCGCGTGTATGTAACGTAGACG -> AGCGCGTGTATGTAACGTAGACGC
TGGTCGAACAAGATGGCCACGTAT -> GGTCGAACAAGATGGCCACGTATA
TCGAACAAGATGGCCACGTATACG -> CGAACAAGATGGCCACGTATACGG
TTGTGAAGACCCGGTCGTGTGGCC -> TGTGAAGACCCGGTCGTGTGGCCG
CAAGGGCTTCTAACGCTGGCTTAA -> AAGGGCTTCTAACGCTGGCTTAAC
AACGTTAAATTACCTGGGGCCCGG -> ACGTTAAATTACCTGGGGCCCGGG
GCGTCGGGCCATTTGCTGCATGCT -> CGTCGGGCCATTTGCTGCATGCTC
TAGAGGAGACCCCAATGAAATGTA -> AGAGGAGACCCCAATGAAATGTAT
GGAACATGCAGCTGAAGCGTCGGG -> GAACATGCAGCTGAAGCGTCGGGC
CAGTATCGCGGATGAGAACAATGT -> AGTATCGCGGATGAGAACAATGTG
CCTTGCGAGCGATTACCTAATAGT -> CTTGCGAGCGATTACCTAATAGTC
CGAAAGCCCGACGGCCACTGTCAC -> GAAAGCCCGACGGCCACTGTCACC
GTTTAGCCTACCATCATGCAGCCT -> TTTAGCCTACCATCATGCAGCCTA
ACTCTAGATTACAAGTTCCACGGG -> CTCTAGATTACAAGTTCCACGGGG
CGTAGTACAGTATTGTGAAGACCC -> GTAGTACAGTATTGTGAAGACCCG
TCCACGGGGGTGGATCCCGGGCTG -> CCACGGGGGTGGATCCCGGGCTGC
AGATAGCCTCGGTTTGCGGAGGCT -> GATAGCCTCGGTTTGCGGAGGCTG
ATACATGCGGGCTTTATCAGACCT -> TACATGCGGGCTTTATCAGACCTG
TTTAGCCTACCATCATGCAGCCTA -> TTAGCCTACCATCATGCAGCCTAC
TGCTCGTACCGCCTTAGCGAGCGG -> GCTCGTACCGCCTTAGCGAGCGGT
TGAAGAGTTACAGATCCGGGCAAG -> GAAGAGTTACAGATCCGGGCAAGT
CAACGTCCCTTACAGTTCTCCACC -> AACGTCCCTTACAGTTCTCCACCT
GACTACTCATCTTGATTATCTGCG -> ACTACTCATCTTGATTATCTGCGG
TCGGGTGGCCGTTATCCCACCAAT -> CGGGTGGCCGTTATCCCACCAATC
GAACAGTTATCGTTTGCAGCCGTC -> AACAGTTATCGTTTGCAGCCGTCG
CGGATCTTTCAGAAACTCAGTGCC -> GGATCTTTCAGAAACTCAGTGCCA
TGGTCTTTATTTTGTTGTTGCGGT -> GGTCTTTATTTTGTTGTTGCGGTC
GATGTTCAATGGTGAGCGTTATGT -> ATGTTCAATGGTGAGCGTTATGTC
GTAGGCAGCGTACAGAAAATCAAG -> TAGGCAGCGTACAGAAAATCAAGC
CACCGCCCGTAAGATGGGACGGTA -> ACCGCCCGTAAGATGGGACGGTAC
AAAAAAGTTGTGTTCTGGATGTGA -> AAAAAGTTGTGTTCTGGATGTGAA
CGTGTGTAGGGAACATGCAGCTGA -> GTGTGTAGGGAACATGCAGCTGAA
GTCGTCGTGTATCACTCAGTAGGT -> TCGTCGTGTATCACTCAGTAGGTT
CGAACAAGATGGCCACGTATACGG -> GAACAAGATGGCCACGTATACGGT
AATTGCGGCTGCGGCCAAGGCTCT -> ATTGCGGCTGCGGCCAAGGCTCTG
CAACGCACAGTTTGTTTACCATGG -> AACGCACAGTTTGTTTACCATGGT
GCAGCCTACTGATGTAGAGGAGAC -> CAGCCTACTGATGTAGAGGAGACC
GTCGGGGGAGGCTTTCGTCGAATG -> TCGGGGGAGGCTTTCGTCGAATGA
TTTTGTTGTTGCGGTCACTCGTCT -> TTTGTTGTTGCGGTCACTCGTCTC
TGAAATGTATGTATAAGTTGCGTC -> GAAATGTATGTATAAGTTGCGTCG
GCGCCCGGCTACAGCGAGCGGAAA -> CGCCCGGCTACAGCGAGCGGAAAT
AAAGACATTTAAAGACTGCGATGG -> AAGACATTTAAAGACTGCGATGGA
CGTACCGCCTTAGCGAGCGGTGGC -> GTACCGCCTTAGCGAGCGGTGGCG
TCTCCACCTTGCGAGCGATTACCT -> CTCCACCTTGCGAGCGATTACCTA
CGTGTGGCCGGCAACTATCCCTTG -> GTGTGGCCGGCAACTATCCCTTGC
TACACATACGTGTGTAGGGAACAT -> ACACATACGTGTGTAGGGAACATG
GCCTACCATCATGCAGCCTACTGA -> CCTACCATCATGCAGCCTACTGAT
TTACCATGGTTCGGGTGGCCGTTA -> TACCATGGTTCGGGTGGCCGTTAT
TTTCGTCGAATGAAGCGCGTGTAT -> TTCGTCGAATGAAGCGCGTGTATG
ACAATGTGAAACTTGAAGATTTCT -> CAATGTGAAACTTGAAGATTTCTG
GCATCAGACTTACCTGTTATCGAA -> CATCAGACTTACCTGTTATCGAAG
GTGGCGGATGTTAGACTCTAGATT -> TGGCGGATGTTAGACTCTAGATTA
AAGCCCGACGGCCACTGTCACCCT -> AGCCCGACGGCCACTGTCACCCTC
TTAGGCGCAACAAAGACATTTAAA -> TAGGCGCAACAAAGACATTTAAAG
TCTGCCCTAATTGACTAGAAATTG -> CTGCCCTAATTGACTAGAAATTGG
CTCTCGGGTTCGACTTTATTCAAG -> TCTCGGGTTCGACTTTATTCAAGT
ATCGCGCCCTCCCGTAACACATTC -> TCGCGCCCTCCCGTAACACATTCA
CCAAGCTCTTGGGGAAATTGCGGC -> CAAGCTCTTGGGGAAATTGCGGCT
ACAGCCCAATCTAGGCTCTAGGGG -> CAGCCCAATCTAGGCTCTAGGGGG
TGGCCACGTATACGGTAGCTTCCC -> GGCCACGTATACGGTAGCTTCCCA
AAGACTGCGATGGAATTATAATAA -> AGACTGCGATGGAATTATAATAAG
GCGGTGGCGGATGTTAGACTCTAG -> CGGTGGCGGATGTTAGACTCTAGA
TGGGGCCCGGGGGTAGCCTCCGTG -> GGGGCCCGGGGGTAGCCTCCGTGC
TCGAGGAGATAGCCTCGGTTTGCG -> CGAGGAGATAGCCTCGGTTTGCGG
GAGGTTGAGCGAGCGCGAGTGCTA -> AGGTTGAGCGAGCGCGAGTGCTAT
CGGGGGTTTTCACCAGACCTGTTA -> GGGGGTTTTCACCAGACCTGTTAG
CTGTGGCTACTCCAACGCACAGTT -> TGTGGCTACTCCAACGCACAGTTT
GGAGGCTTTCGTCGAATGAAGCGC -> GAGGCTTTCGTCGAATGAAGCGCG
TTGCGGAGGCTGGAAAATTCCGGC -> TGCGGAGGCTGGAAAATTCCGGCC
TACAGATCCGGGCAAGTCTTCCTA -> ACAGATCCGGGCAAGTCTTCCTAG
CCCGCGGGAAACTCTAGTTTGCCC -> CCGCGGGAAACTCTAGTTTGCCCA
CGAGGTTGAGCGAGCGCGAGTGCT -> GAGGTTGAGCGAGCGCGAGTGCTA
CCCGGCTACAGCGAGCGGAAATGG -> CCGGCTACAGCGAGCGGAAATGGG
AACAGTTATCGTTTGCAGCCGTCG -> ACAGTTATCGTTTGCAGCCGTCGG
CGATAGGCCTGTGGCCTGGGTAAC -> GATAGGCCTGTGGCCTGGGTAACC
ATCACGCGAGAAACGTTAAATTAC -> TCACGCGAGAAACGTTAAATTACC
TAATAAGCGAAATCGCGCCCTCCC -> AATAAGCGAAATCGCGCCCTCCCG
CGGCTTTGCTGATACATGCGGGCT -> GGCTTTGCTGATACATGCGGGCTT
AAAAGTTGTGTTCTGGATGTGAAC -> AAAGTTGTGTTCTGGATGTGAACG
ATTAGGCGCAACAAAGACATTTAA -> TTAGGCGCAACAAAGACATTTAAA
GGACTACACATACGTGTGTAGGGA -> GACTACACATACGTGTGTAGGGAA
GATGGAATTATAATAAGCGAAATC -> ATGGAATTATAATAAGCGAAATCG
AAATTCCGGCCATGTAGCGTAGTA -> AATTCCGGCCATGTAGCGTAGTAC
AGTTCAGGGTTCATTCGCGTCACG -> GTTCAGGGTTCATTCGCGTCACGC
TGTGAACTGAGCAGCTGCGCCCGG -> GTGAACTGAGCAGCTGCGCCCGGC
AACTCGGATGAACCGCTGGAGGCC -> ACTCGGATGAACCGCTGGAGGCCG
TCCCACCAATCACAGCATGTTCAA -> CCCACCAATCACAGCATGTTCAAT
CTGCGGCGTCGGGGGAGGCTTTCG -> TGCGGCGTCGGGGGAGGCTTTCGT
TGTCAACGTCCCTTACAGTTCTCC -> GTCAACGTCCCTTACAGTTCTCCA
CTCCCGTAACACATTCAAATATCA -> TCCCGTAACACATTCAAATATCAC
TATCGTTTGCAGCCGTCGGAGATG -> ATCGTTTGCAGCCGTCGGAGATGC
GGACACGATCACGCGAGAAACGTT -> GACACGATCACGCGAGAAACGTTA
GGGCTCGAGGTTGAGCGAGCGCGA -> GGCTCGAGGTTGAGCGAGCGCGAG
TAACACATTCAAATATCACCGCTA -> AACACATTCAAATATCACCGCTAA
CCTGGCTTTACGCGCATTAGATCG -> CTGGCTTTACGCGCATTAGATCGT
GGGGTAGCCTCCGTGCCTCCCGGG -> GGGTAGCCTCCGTGCCTCCCGGGG
CCTGTGGCCTGGGTAACCTAACGG -> CTGTGGCCTGGGTAACCTAACGGG
TTGATCCTGGCTTTACGCGCATTA -> TGATCCTGGCTTTACGCGCATTAG
TTTGCCCAAGCTCTTGGGGAAATT -> TTGCCCAAGCTCTTGGGGAAATTG
GCCTGTGGCTACTCCAACGCACAG -> CCTGTGGCTACTCCAACGCACAGT
ACAGTGCCAATTCGATTCGATAAC -> CAGTGCCAATTCGATTCGATAACT
TCTGCGGCGTCGGGGGAGGCTTTC -> CTGCGGCGTCGGGGGAGGCTTTCG
CTAAGGTGGGAACATCAGACAGAA -> TAAGGTGGGAACATCAGACAGAAA
ACATTCAAATATCACCGCTAAGTG -> CATTCAAATATCACCGCTAAGTGG
TATCAGACCTGACCTAAACCGAAT -> ATCAGACCTGACCTAAACCGAATT
CCGGGCAAGTCTTCCTAGATGTCG -> CGGGCAAGTCTTCCTAGATGTCGG
CCTAAGCCGGATGTTCAATGGTGA -> CTAAGCCGGATGTTCAATGGTGAG
GTCGTCGTGGGTGCTCGTACCGCC -> TCGTCGTGGGTGCTCGTACCGCCT
ACCGCCCGTAAGATGGGACGGTAC -> CCGCCCGTAAGATGGGACGGTACC
GATACATGCGGGCTTTATCAGACC -> ATACATGCGGGCTTTATCAGACCT
AAACACCGCCCGTAAGATGGGACG -> AACACCGCCCGTAAGATGGGACGG
AGCGCCTGTAGGCAGCGTACAGAA -> GCGCCTGTAGGCAGCGTACAGAAA
CCGGTCCCTCAGAGACAGTGCCAA -> CGGTCCCTCAGAGACAGTGCCAAT
GTTAGGGCTCGAGGTTGAGCGAGC -> TTAGGGCTCGAGGTTGAGCGAGCG
GGGTCAGTATCGCGGATGAGAACA -> GGTCAGTATCGCGGATGAGAACAA
ACAGCGAGCGGAAATGGGCGGGTA -> CAGCGAGCGGAAATGGGCGGGTAG
GTACAGTATTGTGAAGACCCGGTC -> TACAGTATTGTGAAGACCCGGTCG
AGCGGTGGCGGATGTTAGACTCTA -> GCGGTGGCGGATGTTAGACTCTAG
AGGGTTCATTCGCGTCACGCCGCA -> GGGTTCATTCGCGTCACGCCGCAT
TACCATACTTCAGCCAATTGGAGC -> ACCATACTTCAGCCAATTGGAGCA
GCAATCGGACACGATCACGCGAGA -> CAATCGGACACGATCACGCGAGAA
GTCACCCTCCCGTCCAGTGCCTGC -> TCACCCTCCCGTCCAGTGCCTGCC
GTTGGATCCGAACACCACACGGAG -> TTGGATCCGAACACCACACGGAGT
TCGGATGAACCGCTGGAGGCCGAC -> CGGATGAACCGCTGGAGGCCGACG
CCAATTCGATTCGATAACTAAGGT -> CAATTCGATTCGATAACTAAGGTG
CGTCCAGTGCCTGCCTAGACATAG -> GTCCAGTGCCTGCCTAGACATAGA
TATCCCACCAATCACAGCATGTTC -> ATCCCACCAATCACAGCATGTTCA
GTCGAGAGATTAAAAACACCGCCC -> TCGAGAGATTAAAAACACCGCCCG
ACATTTAAAGACTGCGATGGAATT -> CATTTAAAGACTGCGATGGAATTA
CCTCCGTGCCTCCCGGGGCCCCTG -> CTCCGTGCCTCCCGGGGCCCCTGA
GTTGACCCAATGAGAGCGCCTGTA -> TTGACCCAATGAGAGCGCCTGTAG
GGCTTAACTCCTGTGGTGTCCGCC -> GCTTAACTCCTGTGGTGTCCGCCA
GTTTACCATGGTTCGGGTGGCCGT -> TTTACCATGGTTCGGGTGGCCGTT
CTTAGCGAGCGGTGGCGGATGTTA -> TTAGCGAGCGGTGGCGGATGTTAG
ACTTACCTGTTATCGAAGATTGAG -> CTTACCTGTTATCGAAGATTGAGT
GCCTGTGGCCTGGGTAACCTAACG -> CCTGTGGCCTGGGTAACCTAACGG
TACTCCAACGCACAGTTTGTTTAC -> ACTCCAACGCACAGTTTGTTTACC
AACTAAGGTGGGAACATCAGACAG -> ACTAAGGTGGGAACATCAGACAGA
TACAGTTCTCCACCTTGCGAGCGA -> ACAGTTCTCCACCTTGCGAGCGAT
ACGCACAGACATTAGGGTTCATGG -> CGCACAGACATTAGGGTTCATGGT
TGTGGCTACTCCAACGCACAGTTT -> GTGGCTACTCCAACGCACAGTTTG
CATTTTCAATCATATTGATCCTGG -> ATTTTCAATCATATTGATCCTGGC
GAGTCGTCGTGTATCACTCAGTAG -> AGTCGTCGTGTATCACTCAGTAGG
CGCGCATTAGATCGTTGTGAACTG -> GCGCATTAGATCGTTGTGAACTGA
GTGTGTAGGGAACATGCAGCTGAA -> TGTGTAGGGAACATGCAGCTGAAG
GGATGTTAGACTCTAGATTACAAG -> GATGTTAGACTCTAGATTACAAGT
CTTGCGAGCGATTACCTAATAGTC -> TTGCGAGCGATTACCTAATAGTCC
CCCAATGAAATGTATGTATAAGTT -> CCAATGAAATGTATGTATAAGTTG
CGTAGACGCACAGACATTAGGGTT -> GTAGACGCACAGACATTAGGGTTC
GATCCGAACACCACACGGAGTTGA -> ATCCGAACACCACACGGAGTTGAC
TGACCTAAACCGAATTCAATTAGG -> GACCTAAACCGAATTCAATTAGGC
CCGGCTTATGGGGGTAGCCGAAAG -> CGGCTTATGGGGGTAGCCGAAAGC
TCAATGGTGAGCGTTATGTCAACG -> CAATGGTGAGCGTTATGTCAACGT
CCACCAATCACAGCATGTTCAATT -> CACCAATCACAGCATGTTCAATTC
AGGCGCAACAAAGACATTTAAAGA -> GGCGCAACAAAGACATTTAAAGAC
TGACTAGAAATTGGACTACACATA -> GACTAGAAATTGGACTACACATAC
GGGTTCATTCGCGTCACGCCGCAT -> GGTTCATTCGCGTCACGCCGCATT
CTTTCGTCGAATGAAGCGCGTGTA -> TTTCGTCGAATGAAGCGCGTGTAT
AGATTTCTGCCCTAATTGACTAGA -> GATTTCTGCCCTAATTGACTAGAA
ACAGACATTAGGGTTCATGGTCTT -> CAGACATTAGGGTTCATGGTCTTT
GTCACTCGTCTCCTCTCGGGTTCG -> TCACTCGTCTCCTCTCGGGTTCGA
AAACTCGGATGAACCGCTGGAGGC -> AACTCGGATGAACCGCTGGAGGCC
TGAGTTGCGGGGGTTTTCACCAGA -> GAGTTGCGGGGGTTTTCACCAGAC
GACCCCAATGAAATGTATGTATAA -> ACCCCAATGAAATGTATGTATAAG
CTGACCTAAACCGAATTCAATTAG -> TGACCTAAACCGAATTCAATTAGG
TTGCGGCTGCGGCCAAGGCTCTGT -> TGCGGCTGCGGCCAAGGCTCTGTT
CAATCTAGGCTCTAGGGGGCTAGC -> AATCTAGGCTCTAGGGGGCTAGCG
CGGAGTTGACCCAATGAGAGCGCC -> GGAGTTGACCCAATGAGAGCGCCT
AACATGCAGCTGAAGCGTCGGGCC -> ACATGCAGCTGAAGCGTCGGGCCA
CACCAGACCTGTTAGGGTTGGATC -> ACCAGACCTGTTAGGGTTGGATCC
GCATTGCATCAGACTTACCTGTTA -> CATTGCATCAGACTTACCTGTTAT
CCACGGGGGTGGATCCCGGGCTGC -> CACGGGGGTGGATCCCGGGCTGCT
CCCACCAATCACAGCATGTTCAAT -> CCACCAATCACAGCATGTTCAATT
TGTGAAGACCCGGTCGTGTGGCCG -> GTGAAGACCCGGTCGTGTGGCCGG
AGCCTACCATCATGCAGCCTACTG -> GCCTACCATCATGCAGCCTACTGA
CCGTGAAGGGTCAGTATCGCGGAT -> CGTGAAGGGTCAGTATCGCGGATG
TATCCCTTGCACGTGCCCAATTAG -> ATCCCTTGCACGTGCCCAATTAGA
TGCACGTGCCCAATTAGATGATCA -> GCACGTGCCCAATTAGATGATCAC
ATACGCAATCGAGTTCGTACTGAA -> TACGCAATCGAGTTCGTACTGAAC
ACATTAGGGTTCATGGTCTTTATT -> CATTAGGGTTCATGGTCTTTATTT
CCATTTGCTGCATGCTCTGACAGC -> CATTTGCTGCATGCTCTGACAGCC
ATCTTTCAGAAACTCAGTGCCACC -> TCTTTCAGAAACTCAGTGCCACCC
TGTTGCGGTCACTCGTCTCCTCTC -> GTTGCGGTCACTCGTCTCCTCTCG
GCCGCATTGCATCAGACTTACCTG -> CCGCATTGCATCAGACTTACCTGT
CCGCCTTAGCGAGCGGTGGCGGAT -> CGCCTTAGCGAGCGGTGGCGGATG
GGCTTTCGTCGAATGAAGCGCGTG -> GCTTTCGTCGAATGAAGCGCGTGT
GCGGATGTTAGACTCTAGATTACA -> CGGATGTTAGACTCTAGATTACAA
CCGGCAACTATCCCTTGCACGTGC -> CGGCAACTATCCCTTGCACGTGCC
ACTGACGGACGATAGGCCTGTGGC -> CTGACGGACGATAGGCCTGTGGCC
TGAGGGCCTGTGGCTACTCCAACG -> GAGGGCCTGTGGCTACTCCAACGC
AATCACAGCATGTTCAATTCGATC -> ATCACAGCATGTTCAATTCGATCT
ACGTGCCCAATTAGATGATCACTG -> CGTGCCCAATTAGATGATCACTGA
TCTAGAGCACAACTTTTCACCGGG -> CTAGAGCACAACTTTTCACCGGGA
ATTACAAGTTCCACGGGGGTGGAT -> TTACAAGTTCCACGGGGGTGGATC
AGTTGCGTCGTCGTGGGTGCTCGT -> GTTGCGTCGTCGTGGGTGCTCGTA
GCCATTTGCTGCATGCTCTGACAG -> CCATTTGCTGCATGCTCTGACAGC
GCCGTCGGAGATGCCGGTCCCTCA -> CCGTCGGAGATGCCGGTCCCTCAG
GCCTGTAGGCAGCGTACAGAAAAT -> CCTGTAGGCAGCGTACAGAAAATC
CGTCGGAGATGCCGGTCCCTCAGA -> GTCGGAGATGCCGGTCCCTCAGAG
GCCAATCTGAGTCGTCGTGTATCA -> CCAATCTGAGTCGTCGTGTATCAC
TTATCAGACCTGACCTAAACCGAA -> TATCAGACCTGACCTAAACCGAAT
TGCCAATTCGATTCGATAACTAAG -> GCCAATTCGATTCGATAACTAAGG
TTGCGTCGTCGTGGGTGCTCGTAC -> TGCGTCGTCGTGGGTGCTCGTACC
GGGGGTAGCCTCCGTGCCTCCCGG -> GGGGTAGCCTCCGTGCCTCCCGGG
GTTATCGAAGATTGAGTTGCGGGG -> TTATCGAAGATTGAGTTGCGGGGG
TCGACAAGGGCTTCTAACGCTGGC -> CGACAAGGGCTTCTAACGCTGGCT
GTGTATGTAACGTAGACGCACAGA -> TGTATGTAACGTAGACGCACAGAC
GTAGACGCACAGACATTAGGGTTC -> TAGACGCACAGACATTAGGGTTCA
AACACCGCCCGTAAGATGGGACGG -> ACACCGCCCGTAAGATGGGACGGT
CACACCATTTTCAATCATATTGAT -> ACACCATTTTCAATCATATTGATC
GGCCAATCTGAGTCGTCGTGTATC -> GCCAATCTGAGTCGTCGTGTATCA
ACCATCATGCAGCCTACTGATGTA -> CCATCATGCAGCCTACTGATGTAG
GCAAGTCTTCCTAGATGTCGGATC -> CAAGTCTTCCTAGATGTCGGATCT
GGGCTAGCGCATACCATACTTCAG -> GGCTAGCGCATACCATACTTCAGC
CGGAGGCTGGAAAATTCCGGCCAT -> GGAGGCTGGAAAATTCCGGCCATG
GATCACGCGAGAAACGTTAAATTA -> ATCACGCGAGAAACGTTAAATTAC
TTCGTACTGAACAGTTATCGTTTG -> TCGTACTGAACAGTTATCGTTTGC
GTGGTCGAACAAGATGGCCACGTA -> TGGTCGAACAAGATGGCCACGTAT
ATCGAGTTCGTACTGAACAGTTAT -> TCGAGTTCGTACTGAACAGTTATC
GGTAGAATTGAGAGCATGTCGAGA -> GTAGAATTGAGAGCATGTCGAGAG
AGACGCTAAACATGCCGACTACTC -> GACGCTAAACATGCCGACTACTCA
TTGCATCAGACTTACCTGTTATCG -> TGCATCAGACTTACCTGTTATCGA
TTTCAGAAACTCAGTGCCACCCGC -> TTCAGAAACTCAGTGCCACCCGCG
AGCGCGTGTATGTAACGTAGACGC -> GCGCGTGTATGTAACGTAGACGCA
CATTAGGGTTCATGGTCTTTATTT -> ATTAGGGTTCATGGTCTTTATTTT
TGGCCAATCTGAGTCGTCGTGTAT -> GGCCAATCTGAGTCGTCGTGTATC
GTCGTGTGGCCGGCAACTATCCCT -> TCGTGTGGCCGGCAACTATCCCTT
GTGCTATGTCGACAAGGGCTTCTA -> TGCTATGTCGACAAGGGCTTCTAA
GAAGGGTCAGTATCGCGGATGAGA -> AAGGGTCAGTATCGCGGATGAGAA
CCAATGAGAGCGCCTGTAGGCAGC -> CAATGAGAGCGCCTGTAGGCAGCG
GACATAGAGACTGACGGACGATAG -> ACATAGAGACTGACGGACGATAGG
GAGCAGCTGCGCCCGGCTACAGCG -> AGCAGCTGCGCCCGGCTACAGCGA
TTGGACTACACATACGTGTGTAGG -> TGGACTACACATACGTGTGTAGGG
GCGGAAATGGGCGGGTAGAATTGA -> CGGAAATGGGCGGGTAGAATTGAG
GGATCCGAACACCACACGGAGTTG -> GATCCGAACACCACACGGAGTTGA
TAGTTTGCCCAAGCTCTTGGGGAA -> AGTTTGCCCAAGCTCTTGGGGAAA
GGCTAGTTCAGGGTTCATTCGCGT -> GCTAGTTCAGGGTTCATTCGCGTC
CCGGCTAGTTCAGGGTTCATTCGC -> CGGCTAGTTCAGGGTTCATTCGCG
TTACAGATCCGGGCAAGTCTTCCT -> TACAGATCCGGGCAAGTCTTCCTA
TAGGCGCAACAAAGACATTTAAAG -> AGGCGCAACAAAGACATTTAAAGA
GTTCGTACTGAACAGTTATCGTTT -> TTCGTACTGAACAGTTATCGTTTG
GACAAGGGCTTCTAACGCTGGCTT -> ACAAGGGCTTCTAACGCTGGCTTA
CCAATCTGAGTCGTCGTGTATCAC -> CAATCTGAGTCGTCGTGTATCACT
GCAGCGTACAGAAAATCAAGCATA -> CAGCGTACAGAAAATCAAGCATAG
TCAGTGCCACCCGCGGGAAACTCT -> CAGTGCCACCCGCGGGAAACTCTA
TGCGGGCTTTATCAGACCTGACCT -> GCGGGCTTTATCAGACCTGACCTA
GAGGCTTTCGTCGAATGAAGCGCG -> AGGCTTTCGTCGAATGAAGCGCGT
ACAGTATTGTGAAGACCCGGTCGT -> CAGTATTGTGAAGACCCGGTCGTG
CCAGACCTGTTAGGGTTGGATCCG -> CAGACCTGTTAGGGTTGGATCCGA
GCATTAGATCGTTGTGAACTGAGC -> CATTAGATCGTTGTGAACTGAGCA
GTTGTTGCGGTCACTCGTCTCCTC -> TTGTTGCGGTCACTCGTCTCCTCT
CTCGTACCGCCTTAGCGAGCGGTG -> TCGTACCGCCTTAGCGAGCGGTGG
TGTCACCCTCCCGTCCAGTGCCTG -> GTCACCCTCCCGTCCAGTGCCTGC
TTGAGAGCATGTCGAGAGATTAAA -> TGAGAGCATGTCGAGAGATTAAAA
TTAAATTACCTGGGGCCCGGGGGT -> TAAATTACCTGGGGCCCGGGGGTA
GAAGCGTCGGGCCATTTGCTGCAT -> AAGCGTCGGGCCATTTGCTGCATG
GCGTCGTCGTGGGTGCTCGTACCG -> CGTCGTCGTGGGTGCTCGTACCGC
GCGCCCTCCCGTAACACATTCAAA -> CGCCCTCCCGTAACACATTCAAAT
ACGCGAGAAACGTTAAATTACCTG -> CGCGAGAAACGTTAAATTACCTGG
TGGCTTAACTCCTGTGGTGTCCGC -> GGCTTAACTCCTGTGGTGTCCGCC
GCGGGAAACTCTAGTTTGCCCAAG -> CGGGAAACTCTAGTTTGCCCAAGC
ACCTAACGGGGCCGGCTAGTTCAG -> CCTAACGGGGCCGGCTAGTTCAGG
CGCGGGAAACTCTAGTTTGCCCAA -> GCGGGAAACTCTAGTTTGCCCAAG
GATTACAAGTTCCACGGGGGTGGA -> ATTACAAGTTCCACGGGGGTGGAT
AGCGCATACCATACTTCAGCCAAT -> GCGCATACCATACTTCAGCCAATT
TAACGGGGCCGGCTAGTTCAGGGT -> AACGGGGCCGGCTAGTTCAGGGTT
CATGGTTCGGGTGGCCGTTATCCC -> ATGGTTCGGGTGGCCGTTATCCCA
CTAAACATGCCGACTACTCATCTT -> TAAACATGCCGACTACTCATCTTG
GTTAGGGTTGGATCCGAACACCAC -> TTAGGGTTGGATCCGAACACCACA
TGGAGCACACCATTTTCAATCATA -> GGAGCACACCATTTTCAATCATAT
CTGTTATCGAAGATTGAGTTGCGG -> TGTTATCGAAGATTGAGTTGCGGG
CACTGTCACCCTCCCGTCCAGTGC -> ACTGTCACCCTCCCGTCCAGTGCC
CGGGGCCGGCTAGTTCAGGGTTCA -> GGGGCCGGCTAGTTCAGGGTTCAT
CATTCAAATATCACCGCTAAGTGG -> ATTCAAATATCACCGCTAAGTGGC
TATGTAACGTAGACGCACAGACAT -> ATGTAACGTAGACGCACAGACATT
GAGAGCGCCTGTAGGCAGCGTACA -> AGAGCGCCTGTAGGCAGCGTACAG
TAGCGAGCGGTGGCGGATGTTAGA -> AGCGAGCGGTGGCGGATGTTAGAC
TTGCGAGCGATTACCTAATAGTCC -> TGCGAGCGATTACCTAATAGTCCG
ACGTTAAATTACCTGGGGCCCGGG -> CGTTAAATTACCTGGGGCCCGGGG
TCGGACACGATCACGCGAGAAACG -> CGGACACGATCACGCGAGAAACGT
ACCTGACCTAAACCGAATTCAATT -> CCTGACCTAAACCGAATTCAATTA
CTCTAGATTACAAGTTCCACGGGG -> TCTAGATTACAAGTTCCACGGGGG
CTAAACCGAATTCAATTAGGCGCA -> TAAACCGAATTCAATTAGGCGCAA
CTAGTTCAGGGTTCATTCGCGTCA -> TAGTTCAGGGTTCATTCGCGTCAC
GCCTCCCGGGGCCCCTGAGACTCG -> CCTCCCGGGGCCCCTGAGACTCGA
GCTCTGTTAGGGCTCGAGGTTGAG -> CTCTGTTAGGGCTCGAGGTTGAGC
TTCCACGGGGGTGGATCCCGGGCT -> TCCACGGGGGTGGATCCCGGGCTG
GTTTGCAGCCGTCGGAGATGCCGG -> TTTGCAGCCGTCGGAGATGCCGGT
GCCATGTAGCGTAGTACAGTATTG -> CCATGTAGCGTAGTACAGTATTGT
ATTATCTGCGGCGTCGGGGGAGGC -> TTATCTGCGGCGTCGGGGGAGGCT
GGGGGTGGATCCCGGGCTGCTTAA -> GGGGTGGATCCCGGGCTGCTTAAG
GCGAGCGGTGGCGGATGTTAGACT -> CGAGCGGTGGCGGATGTTAGACTC
CCATTTTCAATCATATTGATCCTG -> CATTTTCAATCATATTGATCCTGG
TACAAGTTCCACGGGGGTGGATCC -> ACAAGTTCCACGGGGGTGGATCCC
TTGAGCGAGCGCGAGTGCTATGTC -> TGAGCGAGCGCGAGTGCTATGTCG
ATGTATAAGTTGCGTCGTCGTGGG -> TGTATAAGTTGCGTCGTCGTGGGT
GGGGCCCCTGAGACTCGAGGAGAT -> GGGCCCCTGAGACTCGAGGAGATA
CAAATATCACCGCTAAGTGGCCAA -> AAATATCACCGCTAAGTGGCCAAT
TGTGTTCTGGATGTGAACGGTCTT -> GTGTTCTGGATGTGAACGGTCTTT
AGGAGATAGCCTCGGTTTGCGGAG -> GGAGATAGCCTCGGTTTGCGGAGG
ATTGATCCTGGCTTTACGCGCATT -> TTGATCCTGGCTTTACGCGCATTA
CCAGCTAGGCAATCGGACACGATC -> CAGCTAGGCAATCGGACACGATCA
CACAACTTTTCACCGGGACTCCGG -> ACAACTTTTCACCGGGACTCCGGC
CGCTAAACATGCCGACTACTCATC -> GCTAAACATGCCGACTACTCATCT
AAGTGAGGGCCTGTGGCTACTCCA -> AGTGAGGGCCTGTGGCTACTCCAA
TAGATGTCGGATCTTTCAGAAACT -> AGATGTCGGATCTTTCAGAAACTC
TACCATGGTTCGGGTGGCCGTTAT -> ACCATGGTTCGGGTGGCCGTTATC
CCGCGGGAAACTCTAGTTTGCCCA -> CGCGGGAAACTCTAGTTTGCCCAA
GAGCGGTGGCGGATGTTAGACTCT -> AGCGGTGGCGGATGTTAGACTCTA
AGCCGGATGTTCAATGGTGAGCGT -> GCCGGATGTTCAATGGTGAGCGTT
GGTCCCTCAGAGACAGTGCCAATT -> GTCCCTCAGAGACAGTGCCAATTC
ATGTCGGATCTTTCAGAAACTCAG -> TGTCGGATCTTTCAGAAACTCAGT
GCTATGTCGACAAGGGCTTCTAAC -> CTATGTCGACAAGGGCTTCTAACG
TTATTCAAGTGAGGGCCTGTGGCT -> TATTCAAGTGAGGGCCTGTGGCTA
GCTAGGCAATCGGACACGATCACG -> CTAGGCAATCGGACACGATCACGC
CATGGTCTTTATTTTGTTGTTGCG -> ATGGTCTTTATTTTGTTGTTGCGG
ACGTTTCGCTATGGAAAAAAAGTT -> CGTTTCGCTATGGAAAAAAAGTTG
ACCGCTGGAGGCCGACGTTTCGCT -> CCGCTGGAGGCCGACGTTTCGCTA
GTTTGTTTACCATGGTTCGGGTGG -> TTTGTTTACCATGGTTCGGGTGGC
GTATCACTCAGTAGGTTTAGCCTA -> TATCACTCAGTAGGTTTAGCCTAC
GCATGTTCAATTCGATCTAGCGTC -> CATGTTCAATTCGATCTAGCGTCT
CGGCCAAGGCTCTGTTAGGGCTCG -> GGCCAAGGCTCTGTTAGGGCTCGA
GACTACACATACGTGTGTAGGGAA -> ACTACACATACGTGTGTAGGGAAC
GAACTGAGCAGCTGCGCCCGGCTA -> AACTGAGCAGCTGCGCCCGGCTAC
GGCTCGAGGTTGAGCGAGCGCGAG -> GCTCGAGGTTGAGCGAGCGCGAGT
CTCTAGGGGGCTAGCGCATACCAT -> TCTAGGGGGCTAGCGCATACCATA
GAAGATTGAGTTGCGGGGGTTTTC -> AAGATTGAGTTGCGGGGGTTTTCA
TCTGACAGCCCAATCTAGGCTCTA -> CTGACAGCCCAATCTAGGCTCTAG
GCATACCATACTTCAGCCAATTGG -> CATACCATACTTCAGCCAATTGGA
CCCGGTCGTGTGGCCGGCAACTAT -> CCGGTCGTGTGGCCGGCAACTATC
AATCTGAGTCGTCGTGTATCACTC -> ATCTGAGTCGTCGTGTATCACTCA
TGTAGGCAGCGTACAGAAAATCAA -> GTAGGCAGCGTACAGAAAATCAAG
ACGCTAAACATGCCGACTACTCAT -> CGCTAAACATGCCGACTACTCATC
CAATGAAATGTATGTATAAGTTGC -> AATGAAATGTATGTATAAGTTGCG
AGATCGTTGTGAACTGAGCAGCTG -> GATCGTTGTGAACTGAGCAGCTGC
GCCGGTCCCTCAGAGACAGTGCCA -> CCGGTCCCTCAGAGACAGTGCCAA
AGCTCTTGGGGAAATTGCGGCTGC -> GCTCTTGGGGAAATTGCGGCTGCG
TCGGAGATGCCGGTCCCTCAGAGA -> CGGAGATGCCGGTCCCTCAGAGAC
AGCGCGAGTGCTATGTCGACAAGG -> GCGCGAGTGCTATGTCGACAAGGG
GATCGTTGTGAACTGAGCAGCTGC -> ATCGTTGTGAACTGAGCAGCTGCG
TTATGGGGGTAGCCGAAAGCCCGA -> TATGGGGGTAGCCGAAAGCCCGAC
TGAGTCGTCGTGTATCACTCAGTA -> GAGTCGTCGTGTATCACTCAGTAG
CTGAAGCGTCGGGCCATTTGCTGC -> TGAAGCGTCGGGCCATTTGCTGCA
ATGCCGGTCCCTCAGAGACAGTGC -> TGCCGGTCCCTCAGAGACAGTGCC
CGGTCTTTCCCTATTCCTAAGCCG -> GGTCTTTCCCTATTCCTAAGCCGG
GGGCTTCTAACGCTGGCTTAACTC -> GGCTTCTAACGCTGGCTTAACTCC
CGGACGATAGGCCTGTGGCCTGGG -> GGACGATAGGCCTGTGGCCTGGGT
CTCTGTTAGGGCTCGAGGTTGAGC -> TCTGTTAGGGCTCGAGGTTGAGCG
TGGGCGGGTAGAATTGAGAGCATG -> GGGCGGGTAGAATTGAGAGCATGT
CCGGCTACAGCGAGCGGAAATGGG -> CGGCTACAGCGAGCGGAAATGGGC
AGAGGAGACCCCAATGAAATGTAT -> GAGGAGACCCCAATGAAATGTATG
CTCGAGGAGATAGCCTCGGTTTGC -> TCGAGGAGATAGCCTCGGTTTGCG
CTCGGGTTCGACTTTATTCAAGTG -> TCGGGTTCGACTTTATTCAAGTGA
CAAGTCTTCCTAGATGTCGGATCT -> AAGTCTTCCTAGATGTCGGATCTT
CACGGAGTTGACCCAATGAGAGCG -> ACGGAGTTGACCCAATGAGAGCGC
TTAGGGCTCGAGGTTGAGCGAGCG -> TAGGGCTCGAGGTTGAGCGAGCGC
ACGTCCCTTACAGTTCTCCACCTT -> CGTCCCTTACAGTTCTCCACCTTG
GGGGAAATTGCGGCTGCGGCCAAG -> GGGAAATTGCGGCTGCGGCCAAGG
GTTCTGGATGTGAACGGTCTTTCC -> TTCTGGATGTGAACGGTCTTTCCC
TGAGACTCGAGGAGATAGCCTCGG -> GAGACTCGAGGAGATAGCCTCGGT
ACAGTTTGTTTACCATGGTTCGGG -> CAGTTTGTTTACCATGGTTCGGGT
CCGTCCAGTGCCTGCCTAGACATA -> CGTCCAGTGCCTGCCTAGACATAG
GCCCGACGGCCACTGTCACCCTCC -> CCCGACGGCCACTGTCACCCTCCC
TAGCGCATACCATACTTCAGCCAA -> AGCGCATACCATACTTCAGCCAAT
GTGTTCTGGATGTGAACGGTCTTT -> TGTTCTGGATGTGAACGGTCTTTC
CAAAGACATTTAAAGACTGCGATG -> AAAGACATTTAAAGACTGCGATGG
AAGCCGGATGTTCAATGGTGAGCG -> AGCCGGATGTTCAATGGTGAGCGT
GACTCCGGCTTTGCTGATACATGC -> ACTCCGGCTTTGCTGATACATGCG
ACCCAATGAGAGCGCCTGTAGGCA -> CCCAATGAGAGCGCCTGTAGGCAG
TGCTCTGACAGCCCAATCTAGGCT -> GCTCTGACAGCCCAATCTAGGCTC
TCAACGTCCCTTACAGTTCTCCAC -> CAACGTCCCTTACAGTTCTCCACC
CTTTATTCAAGTGAGGGCCTGTGG -> TTTATTCAAGTGAGGGCCTGTGGC
TCAGAAACTCAGTGCCACCCGCGG -> CAGAAACTCAGTGCCACCCGCGGG
TTCTGCCCTAATTGACTAGAAATT -> TCTGCCCTAATTGACTAGAAATTG
GCTTCCCATACGCAATCGAGTTCG -> CTTCCCATACGCAATCGAGTTCGT
TGGAAAATTCCGGCCATGTAGCGT -> GGAAAATTCCGGCCATGTAGCGTA
GAGGCTGGAAAATTCCGGCCATGT -> AGGCTGGAAAATTCCGGCCATGTA
CACGATCACGCGAGAAACGTTAAA -> ACGATCACGCGAGAAACGTTAAAT
AATCGCGCCCTCCCGTAACACATT -> ATCGCGCCCTCCCGTAACACATTC
CCCAATCTAGGCTCTAGGGGGCTA -> CCAATCTAGGCTCTAGGGGGCTAG
GTAGAATTGAGAGCATGTCGAGAG -> TAGAATTGAGAGCATGTCGAGAGA
TTTAAAGACTGCGATGGAATTATA -> TTAAAGACTGCGATGGAATTATAA
TGGCCGGCAACTATCCCTTGCACG -> GGCCGGCAACTATCCCTTGCACGT
AGCGGAAATGGGCGGGTAGAATTG -> GCGGAAATGGGCGGGTAGAATTGA
TCAGGGTTCATTCGCGTCACGCCG -> CAGGGTTCATTCGCGTCACGCCGC
CCCGGGGCCCCTGAGACTCGAGGA -> CCGGGGCCCCTGAGACTCGAGGAG
CTAGACATAGAGACTGACGGACGA -> TAGACATAGAGACTGACGGACGAT
TCACCCTCCCGTCCAGTGCCTGCC -> CACCCTCCCGTCCAGTGCCTGCCT
GGAGGCCGACGTTTCGCTATGGAA -> GAGGCCGACGTTTCGCTATGGAAA
ATGTTAGACTCTAGATTACAAGTT -> TGTTAGACTCTAGATTACAAGTTC
TGGGTGCTCGTACCGCCTTAGCGA -> GGGTGCTCGTACCGCCTTAGCGAG
TCGATTCGATAACTAAGGTGGGAA -> CGATTCGATAACTAAGGTGGGAAC
GTGTATCACTCAGTAGGTTTAGCC -> TGTATCACTCAGTAGGTTTAGCCT
CTTTACGCGCATTAGATCGTTGTG -> TTTACGCGCATTAGATCGTTGTGA
AGGGCTCGAGGTTGAGCGAGCGCG -> GGGCTCGAGGTTGAGCGAGCGCGA
AGTTGACCCAATGAGAGCGCCTGT -> GTTGACCCAATGAGAGCGCCTGTA
TGTTCAATTCGATCTAGCGTCTAG -> GTTCAATTCGATCTAGCGTCTAGA
CGAGCGATTACCTAATAGTCCGTG -> GAGCGATTACCTAATAGTCCGTGA
ATCTTGATTATCTGCGGCGTCGGG -> TCTTGATTATCTGCGGCGTCGGGG
CGGGCTTTATCAGACCTGACCTAA -> GGGCTTTATCAGACCTGACCTAAA
TAGGCTCTAGGGGGCTAGCGCATA -> AGGCTCTAGGGGGCTAGCGCATAC
GATGGCCACGTATACGGTAGCTTC -> ATGGCCACGTATACGGTAGCTTCC
GCTTAACTCCTGTGGTGTCCGCCA -> CTTAACTCCTGTGGTGTCCGCCAG
CCCGACGGCCACTGTCACCCTCCC -> CCGACGGCCACTGTCACCCTCCCG
TGAAGCGCGTGTATGTAACGTAGA -> GAAGCGCGTGTATGTAACGTAGAC
GGGAAACTCTAGTTTGCCCAAGCT -> GGAAACTCTAGTTTGCCCAAGCTC
TGAGAGCGCCTGTAGGCAGCGTAC -> GAGAGCGCCTGTAGGCAGCGTACA
CCCAATTAGATGATCACTGAAGAG -> CCAATTAGATGATCACTGAAGAGT
CATTGCATCAGACTTACCTGTTAT -> ATTGCATCAGACTTACCTGTTATC
TAGTACAGTATTGTGAAGACCCGG -> AGTACAGTATTGTGAAGACCCGGT
ATGTGAACGGTCTTTCCCTATTCC -> TGTGAACGGTCTTTCCCTATTCCT
AGGCTTTCGTCGAATGAAGCGCGT -> GGCTTTCGTCGAATGAAGCGCGTG
CTGCGATGGAATTATAATAAGCGA -> TGCGATGGAATTATAATAAGCGAA
CGTAAGATGGGACGGTACCAGCTA -> GTAAGATGGGACGGTACCAGCTAG
CCTGTTATCGAAGATTGAGTTGCG -> CTGTTATCGAAGATTGAGTTGCGG
ACAGCATGTTCAATTCGATCTAGC -> CAGCATGTTCAATTCGATCTAGCG
GTGAGGGCCTGTGGCTACTCCAAC -> TGAGGGCCTGTGGCTACTCCAACG
GGACTCCGGCTTTGCTGATACATG -> GACTCCGGCTTTGCTGATACATGC
GTATAAGTTGCGTCGTCGTGGGTG -> TATAAGTTGCGTCGTCGTGGGTGC
CGAGTTCGTACTGAACAGTTATCG -> GAGTTCGTACTGAACAGTTATCGT
AGACATAGAGACTGACGGACGATA -> GACATAGAGACTGACGGACGATAG
ACAGATCCGGGCAAGTCTTCCTAG -> CAGATCCGGGCAAGTCTTCCTAGA
CTTGAAGATTTCTGCCCTAATTGA -> TTGAAGATTTCTGCCCTAATTGAC
TGGGGAAATTGCGGCTGCGGCCAA -> GGGGAAATTGCGGCTGCGGCCAAG
GGTTGAGCGAGCGCGAGTGCTATG -> GTTGAGCGAGCGCGAGTGCTATGT
GGTAGCCGAAAGCCCGACGGCCAC -> GTAGCCGAAAGCCCGACGGCCACT
GGCTCTAGGGGGCTAGCGCATACC -> GCTCTAGGGGGCTAGCGCATACCA
GTAGGGAACATGCAGCTGAAGCGT -> TAGGGAACATGCAGCTGAAGCGTC
AGGGTGTGGTCGAACAAGATGGCC -> GGGTGTGGTCGAACAAGATGGCCA
CGCGAGTGCTATGTCGACAAGGGC -> GCGAGTGCTATGTCGACAAGGGCT
GGGCGGGTAGAATTGAGAGCATGT -> GGCGGGTAGAATTGAGAGCATGTC
GACCTGTTAGGGTTGGATCCGAAC -> ACCTGTTAGGGTTGGATCCGAACA
TTGTTTACCATGGTTCGGGTGGCC -> TGTTTACCATGGTTCGGGTGGCCG
CCTCCCGTCCAGTGCCTGCCTAGA -> CTCCCGTCCAGTGCCTGCCTAGAC
CCTCCCGGGGCCCCTGAGACTCGA -> CTCCCGGGGCCCCTGAGACTCGAG
CCGGGACTCCGGCTTTGCTGATAC -> CGGGACTCCGGCTTTGCTGATACA
GACTGCGATGGAATTATAATAAGC -> ACTGCGATGGAATTATAATAAGCG
ACTCGGATGAACCGCTGGAGGCCG -> CTCGGATGAACCGCTGGAGGCCGA
CTACTGATGTAGAGGAGACCCCAA -> TACTGATGTAGAGGAGACCCCAAT
GTTGCGGGGGTTTTCACCAGACCT -> TTGCGGGGGTTTTCACCAGACCTG
GGGGGCTAGCGCATACCATACTTC -> GGGGCTAGCGCATACCATACTTCA
GGAAATTGCGGCTGCGGCCAAGGC -> GAAATTGCGGCTGCGGCCAAGGCT
CTGAAGAGTTACAGATCCGGGCAA -> TGAAGAGTTACAGATCCGGGCAAG
CGCGAGAAACGTTAAATTACCTGG -> GCGAGAAACGTTAAATTACCTGGG
TCTAGCGTCTAGAGCACAACTTTT -> CTAGCGTCTAGAGCACAACTTTTC
CAGTGCCACCCGCGGGAAACTCTA -> AGTGCCACCCGCGGGAAACTCTAG
CGTTAAATTACCTGGGGCCCGGGG -> GTTAAATTACCTGGGGCCCGGGGG
AACCTAACGGGGCCGGCTAGTTCA -> ACCTAACGGGGCCGGCTAGTTCAG
TTAGACTCTAGATTACAAGTTCCA -> TAGACTCTAGATTACAAGTTCCAC
GAAGCGCGTGTATGTAACGTAGAC -> AAGCGCGTGTATGTAACGTAGACG
GTGGCTACTCCAACGCACAGTTTG -> TGGCTACTCCAACGCACAGTTTGT
CGCATACCATACTTCAGCCAATTG -> GCATACCATACTTCAGCCAATTGG
GAGCGCCTGTAGGCAGCGTACAGA -> AGCGCCTGTAGGCAGCGTACAGAA
AAGTGGCCAATCTGAGTCGTCGTG -> AGTGGCCAATCTGAGTCGTCGTGT
CAATTAGGCGCAACAAAGACATTT -> AATTAGGCGCAACAAAGACATTTA
CAGTGCCAATTCGATTCGATAACT -> AGTGCCAATTCGATTCGATAACTA
CTCAGTAGGTTTAGCCTACCATCA -> TCAGTAGGTTTAGCCTACCATCAT
AAGTTCCACGGGGGTGGATCCCGG -> AGTTCCACGGGGGTGGATCCCGGG
GTTCGGGTGGCCGTTATCCCACCA -> TTCGGGTGGCCGTTATCCCACCAA
CCGCTAAGTGGCCAATCTGAGTCG -> CGCTAAGTGGCCAATCTGAGTCGT
ATTACCTAATAGTCCGTGAAGGGT -> TTACCTAATAGTCCGTGAAGGGTC
CACAGACATTAGGGTTCATGGTCT -> ACAGACATTAGGGTTCATGGTCTT
ACGCCGCATTGCATCAGACTTACC -> CGCCGCATTGCATCAGACTTACCT
ATTGGACTACACATACGTGTGTAG -> TTGGACTACACATACGTGTGTAGG
TCGTCGTGTATCACTCAGTAGGTT -> CGTCGTGTATCACTCAGTAGGTTT
ACTACACATACGTGTGTAGGGAAC -> CTACACATACGTGTGTAGGGAACA
CTCCAACGCACAGTTTGTTTACCA -> TCCAACGCACAGTTTGTTTACCAT
CTGTAGGCAGCGTACAGAAAATCA -> TGTAGGCAGCGTACAGAAAATCAA
CGTCCCTTACAGTTCTCCACCTTG -> GTCCCTTACAGTTCTCCACCTTGC
AGCTAGGCAATCGGACACGATCAC -> GCTAGGCAATCGGACACGATCACG
TCATTCGCGTCACGCCGCATTGCA -> CATTCGCGTCACGCCGCATTGCAT
GAACAAGATGGCCACGTATACGGT -> AACAAGATGGCCACGTATACGGTA
CACCCTCCCGTCCAGTGCCTGCCT -> ACCCTCCCGTCCAGTGCCTGCCTA
TTCCCATACGCAATCGAGTTCGTA -> TCCCATACGCAATCGAGTTCGTAC
ACTCCAACGCACAGTTTGTTTACC -> CTCCAACGCACAGTTTGTTTACCA
CGACTACTCATCTTGATTATCTGC -> GACTACTCATCTTGATTATCTGCG
TAACGTAGACGCACAGACATTAGG -> AACGTAGACGCACAGACATTAGGG
GGGAACATGCAGCTGAAGCGTCGG -> GGAACATGCAGCTGAAGCGTCGGG
GATGATCACTGAAGAGTTACAGAT -> ATGATCACTGAAGAGTTACAGATC
CCACTGTCACCCTCCCGTCCAGTG -> CACTGTCACCCTCCCGTCCAGTGC
TTTGTTGTTGCGGTCACTCGTCTC -> TTGTTGTTGCGGTCACTCGTCTCC
GACTGACGGACGATAGGCCTGTGG -> ACTGACGGACGATAGGCCTGTGGC
TTGCCCAAGCTCTTGGGGAAATTG -> TGCCCAAGCTCTTGGGGAAATTGC
GCTTTGCTGATACATGCGGGCTTT -> CTTTGCTGATACATGCGGGCTTTA
GCGGAGGCTGGAAAATTCCGGCCA -> CGGAGGCTGGAAAATTCCGGCCAT
CTCCTGTGGTGTCCGCCAGACGCT -> TCCTGTGGTGTCCGCCAGACGCTA
ATTCGATAACTAAGGTGGGAACAT -> TTCGATAACTAAGGTGGGAACATC
GGCCTGTGGCCTGGGTAACCTAAC -> GCCTGTGGCCTGGGTAACCTAACG
CGACGTTTCGCTATGGAAAAAAAG -> GACGTTTCGCTATGGAAAAAAAGT
TATGGGGGTAGCCGAAAGCCCGAC -> ATGGGGGTAGCCGAAAGCCCGACG
GTAAGATGGGACGGTACCAGCTAG -> TAAGATGGGACGGTACCAGCTAGG
AAAGACTGCGATGGAATTATAATA -> AAGACTGCGATGGAATTATAATAA
TCGATAACTAAGGTGGGAACATCA -> CGATAACTAAGGTGGGAACATCAG
AGAGCGCCTGTAGGCAGCGTACAG -> GAGCGCCTGTAGGCAGCGTACAGA
GCTGATACATGCGGGCTTTATCAG -> CTGATACATGCGGGCTTTATCAGA
TGATTATCTGCGGCGTCGGGGGAG -> GATTATCTGCGGCGTCGGGGGAGG
CGGTTTGCGGAGGCTGGAAAATTC -> GGTTTGCGGAGGCTGGAAAATTCC
AGAAACTCGGATGAACCGCTGGAG -> GAAACTCGGATGAACCGCTGGAGG
AGGGCCTGTGGCTACTCCAACGCA -> GGGCCTGTGGCTACTCCAACGCAC
CCGACGGCCACTGTCACCCTCCCG -> CGACGGCCACTGTCACCCTCCCGT
GCTCTGACAGCCCAATCTAGGCTC -> CTCTGACAGCCCAATCTAGGCTCT
TGAGAGCATGTCGAGAGATTAAAA -> GAGAGCATGTCGAGAGATTAAAAA
ACCCTCCCGTCCAGTGCCTGCCTA -> CCCTCCCGTCCAGTGCCTGCCTAG
CATGCAGCCTACTGATGTAGAGGA -> ATGCAGCCTACTGATGTAGAGGAG
GTGGCCTGGGTAACCTAACGGGGC -> TGGCCTGGGTAACCTAACGGGGCC
TTCAATGGTGAGCGTTATGTCAAC -> TCAATGGTGAGCGTTATGTCAACG
ACGGGGCCGGCTAGTTCAGGGTTC -> CGGGGCCGGCTAGTTCAGGGTTCA
CATACTTCAGCCAATTGGAGCACA -> ATACTTCAGCCAATTGGAGCACAC
GCCACGTATACGGTAGCTTCCCAT -> CCACGTATACGGTAGCTTCCCATA
TCTTTCCCTATTCCTAAGCCGGAT -> CTTTCCCTATTCCTAAGCCGGATG
GCGCGTGTATGTAACGTAGACGCA -> CGCGTGTATGTAACGTAGACGCAC
GCCGGCTAGTTCAGGGTTCATTCG -> CCGGCTAGTTCAGGGTTCATTCGC
CTCAGAGACAGTGCCAATTCGATT -> TCAGAGACAGTGCCAATTCGATTC
AGTCGTCGTGTATCACTCAGTAGG -> GTCGTCGTGTATCACTCAGTAGGT
CACGTGCCCAATTAGATGATCACT -> ACGTGCCCAATTAGATGATCACTG
CCCTCCCGTAACACATTCAAATAT -> CCTCCCGTAACACATTCAAATATC
GATGAGAACAATGTGAAACTTGAA -> ATGAGAACAATGTGAAACTTGAAG
CCCTATTCCTAAGCCGGATGTTCA -> CCTATTCCTAAGCCGGATGTTCAA
GCGTCACGCCGCATTGCATCAGAC -> CGTCACGCCGCATTGCATCAGACT
AAAAAGTTGTGTTCTGGATGTGAA -> AAAAGTTGTGTTCTGGATGTGAAC
GCGGCCAAGGCTCTGTTAGGGCTC -> CGGCCAAGGCTCTGTTAGGGCTCG
GGGGGTAGCCGAAAGCCCGACGGC -> GGGGTAGCCGAAAGCCCGACGGCC
GGCCATTTGCTGCATGCTCTGACA -> GCCATTTGCTGCATGCTCTGACAG
TCGAGTTCGTACTGAACAGTTATC -> CGAGTTCGTACTGAACAGTTATCG
ATCAGACTTACCTGTTATCGAAGA -> TCAGACTTACCTGTTATCGAAGAT
GAACAATGTGAAACTTGAAGATTT -> AACAATGTGAAACTTGAAGATTTC
CAAGGCTCTGTTAGGGCTCGAGGT -> AAGGCTCTGTTAGGGCTCGAGGTT
GTGTCCGCCAGACGCTAAACATGC -> TGTCCGCCAGACGCTAAACATGCC
TCACTGAAGAGTTACAGATCCGGG -> CACTGAAGAGTTACAGATCCGGGC
TTAGCCTACCATCATGCAGCCTAC -> TAGCCTACCATCATGCAGCCTACT
CCGAACACCACACGGAGTTGACCC -> CGAACACCACACGGAGTTGACCCA
TGCGGCCAAGGCTCTGTTAGGGCT -> GCGGCCAAGGCTCTGTTAGGGCTC
ACCGCCTTAGCGAGCGGTGGCGGA -> CCGCCTTAGCGAGCGGTGGCGGAT
GGGCCATTTGCTGCATGCTCTGAC -> GGCCATTTGCTGCATGCTCTGACA
TAATTGACTAGAAATTGGACTACA -> AATTGACTAGAAATTGGACTACAC
ATTAGATGATCACTGAAGAGTTAC -> TTAGATGATCACTGAAGAGTTACA
TTAGGGTTGGATCCGAACACCACA -> TAGGGTTGGATCCGAACACCACAC
TTCAGCCAATTGGAGCACACCATT -> TCAGCCAATTGGAGCACACCATTT
AGTTCTCCACCTTGCGAGCGATTA -> GTTCTCCACCTTGCGAGCGATTAC
TTTTCAATCATATTGATCCTGGCT -> TTTCAATCATATTGATCCTGGCTT
CTTCTAACGCTGGCTTAACTCCTG -> TTCTAACGCTGGCTTAACTCCTGT
CTGCCCTAATTGACTAGAAATTGG -> TGCCCTAATTGACTAGAAATTGGA
AAGTTGCGTCGTCGTGGGTGCTCG -> AGTTGCGTCGTCGTGGGTGCTCGT
ATCGCGGATGAGAACAATGTGAAA -> TCGCGGATGAGAACAATGTGAAAC
AGAGAAGGGTGTGGTCGAACAAGA -> GAGAAGGGTGTGGTCGAACAAGAT
CTGCCTAGACATAGAGACTGACGG -> TGCCTAGACATAGAGACTGACGGA
TGAACTGAGCAGCTGCGCCCGGCT -> GAACTGAGCAGCTGCGCCCGGCTA
AGCAGCTGCGCCCGGCTACAGCGA -> GCAGCTGCGCCCGGCTACAGCGAG
GAAACGTTAAATTACCTGGGGCCC -> AAACGTTAAATTACCTGGGGCCCG
AGAAACTCAGTGCCACCCGCGGGA -> GAAACTCAGTGCCACCCGCGGGAA
TTTATTTTGTTGTTGCGGTCACTC -> TTATTTTGTTGTTGCGGTCACTCG
ATGTCGAGAGATTAAAAACACCGC -> TGTCGAGAGATTAAAAACACCGCC
TAGACTCTAGATTACAAGTTCCAC -> AGACTCTAGATTACAAGTTCCACG
AACATCAGACAGAAACTCGGATGA -> ACATCAGACAGAAACTCGGATGAA
TATCACTCAGTAGGTTTAGCCTAC -> ATCACTCAGTAGGTTTAGCCTACC
TAAAAACACCGCCCGTAAGATGGG -> AAAAACACCGCCCGTAAGATGGGA
AGAGATTAAAAACACCGCCCGTAA -> GAGATTAAAAACACCGCCCGTAAG
GCCCAAGCTCTTGGGGAAATTGCG -> CCCAAGCTCTTGGGGAAATTGCGG
ATTCGATTCGATAACTAAGGTGGG -> TTCGATTCGATAACTAAGGTGGGA
GCCCGGCTACAGCGAGCGGAAATG -> CCCGGCTACAGCGAGCGGAAATGG
TGAGAACAATGTGAAACTTGAAGA -> GAGAACAATGTGAAACTTGAAGAT
GGCTTTATCAGACCTGACCTAAAC -> GCTTTATCAGACCTGACCTAAACC
ACAGTTATCGTTTGCAGCCGTCGG -> CAGTTATCGTTTGCAGCCGTCGGA
TGCGAGCGATTACCTAATAGTCCG -> GCGAGCGATTACCTAATAGTCCGT
ACTCGTCTCCTCTCGGGTTCGACT -> CTCGTCTCCTCTCGGGTTCGACTT
CGTGTATGTAACGTAGACGCACAG -> GTGTATGTAACGTAGACGCACAGA
TCAAGCATAGAGAAGGGTGTGGTC -> CAAGCATAGAGAAGGGTGTGGTCG
ATGGGGGTAGCCGAAAGCCCGACG -> TGGGGGTAGCCGAAAGCCCGACGG
CATATTGATCCTGGCTTTACGCGC -> ATATTGATCCTGGCTTTACGCGCA
GGATGAGAACAATGTGAAACTTGA -> GATGAGAACAATGTGAAACTTGAA
ACGGTCTTTCCCTATTCCTAAGCC -> CGGTCTTTCCCTATTCCTAAGCCG
AGATGTCGGATCTTTCAGAAACTC -> GATGTCGGATCTTTCAGAAACTCA
CGGCGTCGGGGGAGGCTTTCGTCG -> GGCGTCGGGGGAGGCTTTCGTCGA
GAGAAACGTTAAATTACCTGGGGC -> AGAAACGTTAAATTACCTGGGGCC
CTCCCGGGGCCCCTGAGACTCGAG -> TCCCGGGGCCCCTGAGACTCGAGG
AAATATCACCGCTAAGTGGCCAAT -> AATATCACCGCTAAGTGGCCAATC
TACAGTATTGTGAAGACCCGGTCG -> ACAGTATTGTGAAGACCCGGTCGT
CAAGTGAGGGCCTGTGGCTACTCC -> AAGTGAGGGCCTGTGGCTACTCCA
ATGGGACGGTACCAGCTAGGCAAT -> TGGGACGGTACCAGCTAGGCAATC
GTGAAGGGTCAGTATCGCGGATGA -> TGAAGGGTCAGTATCGCGGATGAG
ACAGAAAATCAAGCATAGAGAAGG -> CAGAAAATCAAGCATAGAGAAGGG
CTAACGGGGCCGGCTAGTTCAGGG -> TAACGGGGCCGGCTAGTTCAGGGT
TTCGTCGAATGAAGCGCGTGTATG -> TCGTCGAATGAAGCGCGTGTATGT
CATGCAGCTGAAGCGTCGGGCCAT -> ATGCAGCTGAAGCGTCGGGCCATT
ATGTCGACAAGGGCTTCTAACGCT -> TGTCGACAAGGGCTTCTAACGCTG
GTGGTGTCCGCCAGACGCTAAACA -> TGGTGTCCGCCAGACGCTAAACAT
GATGTCGGATCTTTCAGAAACTCA -> ATGTCGGATCTTTCAGAAACTCAG
GGGTTCATGGTCTTTATTTTGTTG -> GGTTCATGGTCTTTATTTTGTTGT
CGGATGTTAGACTCTAGATTACAA -> GGATGTTAGACTCTAGATTACAAG
GATCTTTCAGAAACTCAGTGCCAC -> ATCTTTCAGAAACTCAGTGCCACC
GGAGATGCCGGTCCCTCAGAGACA -> GAGATGCCGGTCCCTCAGAGACAG
GACATTAGGGTTCATGGTCTTTAT -> ACATTAGGGTTCATGGTCTTTATT
AATCGAGTTCGTACTGAACAGTTA -> ATCGAGTTCGTACTGAACAGTTAT
CTACACATACGTGTGTAGGGAACA -> TACACATACGTGTGTAGGGAACAT
ATCTGCGGCGTCGGGGGAGGCTTT -> TCTGCGGCGTCGGGGGAGGCTTTC
CTACTCCAACGCACAGTTTGTTTA -> TACTCCAACGCACAGTTTGTTTAC
CTCGAGGTTGAGCGAGCGCGAGTG -> TCGAGGTTGAGCGAGCGCGAGTGC
TCTAGTTTGCCCAAGCTCTTGGGG -> CTAGTTTGCCCAAGCTCTTGGGGA
AAAATCAAGCATAGAGAAGGGTGT -> AAATCAAGCATAGAGAAGGGTGTG
CAGTTATCGTTTGCAGCCGTCGGA -> AGTTATCGTTTGCAGCCGTCGGAG
AGACTGCGATGGAATTATAATAAG -> GACTGCGATGGAATTATAATAAGC
CGAAGATTGAGTTGCGGGGGTTTT -> GAAGATTGAGTTGCGGGGGTTTTC
CGTGAAGGGTCAGTATCGCGGATG -> GTGAAGGGTCAGTATCGCGGATGA
CCAATTAGATGATCACTGAAGAGT -> CAATTAGATGATCACTGAAGAGTT
ACGATCACGCGAGAAACGTTAAAT -> CGATCACGCGAGAAACGTTAAATT
TCCGCCAGACGCTAAACATGCCGA -> CCGCCAGACGCTAAACATGCCGAC
AGGGTCAGTATCGCGGATGAGAAC -> GGGTCAGTATCGCGGATGAGAACA
ATGAAATGTATGTATAAGTTGCGT -> TGAAATGTATGTATAAGTTGCGTC
GAAGAGTTACAGATCCGGGCAAGT -> AAGAGTTACAGATCCGGGCAAGTC
TCGAGAGATTAAAAACACCGCCCG -> CGAGAGATTAAAAACACCGCCCGT
CGGAGATGCCGGTCCCTCAGAGAC -> GGAGATGCCGGTCCCTCAGAGACA
GCGTCGGGGGAGGCTTTCGTCGAA -> CGTCGGGGGAGGCTTTCGTCGAAT
TCCTCTCGGGTTCGACTTTATTCA -> CCTCTCGGGTTCGACTTTATTCAA
AGAGTTACAGATCCGGGCAAGTCT -> GAGTTACAGATCCGGGCAAGTCTT
TATGGAAAAAAAGTTGTGTTCTGG -> ATGGAAAAAAAGTTGTGTTCTGGA
CCGTAACACATTCAAATATCACCG -> CGTAACACATTCAAATATCACCGC
GTCTTTATTTTGTTGTTGCGGTCA -> TCTTTATTTTGTTGTTGCGGTCAC
GCTATGGAAAAAAAGTTGTGTTCT -> CTATGGAAAAAAAGTTGTGTTCTG
TAAACCGAATTCAATTAGGCGCAA -> AAACCGAATTCAATTAGGCGCAAC
CCTAACGGGGCCGGCTAGTTCAGG -> CTAACGGGGCCGGCTAGTTCAGGG
ATCTGAGTCGTCGTGTATCACTCA -> TCTGAGTCGTCGTGTATCACTCAG
GTGCCTGCCTAGACATAGAGACTG -> TGCCTGCCTAGACATAGAGACTGA
TGACCCAATGAGAGCGCCTGTAGG -> GACCCAATGAGAGCGCCTGTAGGC
CGCCCGGCTACAGCGAGCGGAAAT -> GCCCGGCTACAGCGAGCGGAAATG
GTAACACATTCAAATATCACCGCT -> TAACACATTCAAATATCACCGCTA
AGCGTCGGGCCATTTGCTGCATGC -> GCGTCGGGCCATTTGCTGCATGCT
AAGATGGCCACGTATACGGTAGCT -> AGATGGCCACGTATACGGTAGCTT
GACGCTAAACATGCCGACTACTCA -> ACGCTAAACATGCCGACTACTCAT
GACGATAGGCCTGTGGCCTGGGTA -> ACGATAGGCCTGTGGCCTGGGTAA
CCTTACAGTTCTCCACCTTGCGAG -> CTTACAGTTCTCCACCTTGCGAGC
GCCGTTATCCCACCAATCACAGCA -> CCGTTATCCCACCAATCACAGCAT
CAGCCTACTGATGTAGAGGAGACC -> AGCCTACTGATGTAGAGGAGACCC
ACCTTGCGAGCGATTACCTAATAG -> CCTTGCGAGCGATTACCTAATAGT
GGAAAATTCCGGCCATGTAGCGTA -> GAAAATTCCGGCCATGTAGCGTAG
CGTTTGCAGCCGTCGGAGATGCCG -> GTTTGCAGCCGTCGGAGATGCCGG
TGCAGCCGTCGGAGATGCCGGTCC -> GCAGCCGTCGGAGATGCCGGTCCC
TAGATTACAAGTTCCACGGGGGTG -> AGATTACAAGTTCCACGGGGGTGG
ACACCACACGGAGTTGACCCAATG -> CACCACACGGAGTTGACCCAATGA
CTCCGTGCCTCCCGGGGCCCCTGA -> TCCGTGCCTCCCGGGGCCCCTGAG
AGTGCCAATTCGATTCGATAACTA -> GTGCCAATTCGATTCGATAACTAA
GATCCCGGGCTGCTTAAGACTCAA -> ATCCCGGGCTGCTTAAGACTCAAT
AAGGTGGGAACATCAGACAGAAAC -> AGGTGGGAACATCAGACAGAAACT
TCCTGTGGTGTCCGCCAGACGCTA -> CCTGTGGTGTCCGCCAGACGCTAA
TGAACAGTTATCGTTTGCAGCCGT -> GAACAGTTATCGTTTGCAGCCGTC
TGTATGTAACGTAGACGCACAGAC -> GTATGTAACGTAGACGCACAGACA
CCTGTGGTGTCCGCCAGACGCTAA -> CTGTGGTGTCCGCCAGACGCTAAA
AAATTACCTGGGGCCCGGGGGTAG -> AATTACCTGGGGCCCGGGGGTAGC
GTGAACTGAGCAGCTGCGCCCGGC -> TGAACTGAGCAGCTGCGCCCGGCT
TTGCTGCATGCTCTGACAGCCCAA -> TGCTGCATGCTCTGACAGCCCAAT
ACATACGTGTGTAGGGAACATGCA -> CATACGTGTGTAGGGAACATGCAG
CGGGTTCGACTTTATTCAAGTGAG -> GGGTTCGACTTTATTCAAGTGAGG
ACTCATCTTGATTATCTGCGGCGT -> CTCATCTTGATTATCTGCGGCGTC
GAAACTCAGTGCCACCCGCGGGAA -> AAACTCAGTGCCACCCGCGGGAAA
ATACTTCAGCCAATTGGAGCACAC -> TACTTCAGCCAATTGGAGCACACC
AATTGGAGCACACCATTTTCAATC -> ATTGGAGCACACCATTTTCAATCA
AGAAGGGTGTGGTCGAACAAGATG -> GAAGGGTGTGGTCGAACAAGATGG
ATAGGCCTGTGGCCTGGGTAACCT -> TAGGCCTGTGGCCTGGGTAACCTA
TAAGGTGGGAACATCAGACAGAAA -> AAGGTGGGAACATCAGACAGAAAC
GTACTGAACAGTTATCGTTTGCAG -> TACTGAACAGTTATCGTTTGCAGC
TATTTTGTTGTTGCGGTCACTCGT -> ATTTTGTTGTTGCGGTCACTCGTC
GATTCGATAACTAAGGTGGGAACA -> ATTCGATAACTAAGGTGGGAACAT
ACCAGACCTGTTAGGGTTGGATCC -> CCAGACCTGTTAGGGTTGGATCCG
AGGCTCTAGGGGGCTAGCGCATAC -> GGCTCTAGGGGGCTAGCGCATACC
TAACGCTGGCTTAACTCCTGTGGT -> AACGCTGGCTTAACTCCTGTGGTG
TGGTGTCCGCCAGACGCTAAACAT -> GGTGTCCGCCAGACGCTAAACATG
GACTTTATTCAAGTGAGGGCCTGT -> ACTTTATTCAAGTGAGGGCCTGTG
ACATCAGACAGAAACTCGGATGAA -> CATCAGACAGAAACTCGGATGAAC
GAGAAGGGTGTGGTCGAACAAGAT -> AGAAGGGTGTGGTCGAACAAGATG
AAGATGGGACGGTACCAGCTAGGC -> AGATGGGACGGTACCAGCTAGGCA
TTTGCAGCCGTCGGAGATGCCGGT -> TTGCAGCCGTCGGAGATGCCGGTC
TAAGATGGGACGGTACCAGCTAGG -> AAGATGGGACGGTACCAGCTAGGC
CGTTGTGAACTGAGCAGCTGCGCC -> GTTGTGAACTGAGCAGCTGCGCCC
AAGATTGAGTTGCGGGGGTTTTCA -> AGATTGAGTTGCGGGGGTTTTCAC
CTCTAGTTTGCCCAAGCTCTTGGG -> TCTAGTTTGCCCAAGCTCTTGGGG
GATAGCCTCGGTTTGCGGAGGCTG -> ATAGCCTCGGTTTGCGGAGGCTGG
TTTGCTGCATGCTCTGACAGCCCA -> TTGCTGCATGCTCTGACAGCCCAA
GCTGGCTTAACTCCTGTGGTGTCC -> CTGGCTTAACTCCTGTGGTGTCCG
CGTATACGGTAGCTTCCCATACGC -> GTATACGGTAGCTTCCCATACGCA
CCAAGGCTCTGTTAGGGCTCGAGG -> CAAGGCTCTGTTAGGGCTCGAGGT
GAATTGAGAGCATGTCGAGAGATT -> AATTGAGAGCATGTCGAGAGATTA
GCTGCGCCCGGCTACAGCGAGCGG -> CTGCGCCCGGCTACAGCGAGCGGA
TCACCGCTAAGTGGCCAATCTGAG -> CACCGCTAAGTGGCCAATCTGAGT
TGATGTAGAGGAGACCCCAATGAA -> GATGTAGAGGAGACCCCAATGAAA
ACCTGGGGCCCGGGGGTAGCCTCC -> CCTGGGGCCCGGGGGTAGCCTCCG
CTGCGCCCGGCTACAGCGAGCGGA -> TGCGCCCGGCTACAGCGAGCGGAA
GATAACTAAGGTGGGAACATCAGA -> ATAACTAAGGTGGGAACATCAGAC
TACATGCGGGCTTTATCAGACCTG -> ACATGCGGGCTTTATCAGACCTGA
CTTTCAGAAACTCAGTGCCACCCG -> TTTCAGAAACTCAGTGCCACCCGC
CTTAACTCCTGTGGTGTCCGCCAG -> TTAACTCCTGTGGTGTCCGCCAGA
CGATAACTAAGGTGGGAACATCAG -> GATAACTAAGGTGGGAACATCAGA
GTTCATGGTCTTTATTTTGTTGTT -> TTCATGGTCTTTATTTTGTTGTTG
TAACCTAACGGGGCCGGCTAGTTC -> AACCTAACGGGGCCGGCTAGTTCA
AAGTTGTGTTCTGGATGTGAACGG -> AGTTGTGTTCTGGATGTGAACGGT
GTGGCCAATCTGAGTCGTCGTGTA -> TGGCCAATCTGAGTCGTCGTGTAT
TTGGGGAAATTGCGGCTGCGGCCA -> TGGGGAAATTGCGGCTGCGGCCAA
TTCCCTATTCCTAAGCCGGATGTT -> TCCCTATTCCTAAGCCGGATGTTC
TATTGTGAAGACCCGGTCGTGTGG -> ATTGTGAAGACCCGGTCGTGTGGC
CGGGGGTGGATCCCGGGCTGCTTA -> GGGGGTGGATCCCGGGCTGCTTAA
TTAGATGATCACTGAAGAGTTACA -> TAGATGATCACTGAAGAGTTACAG
GCCCCTGAGACTCGAGGAGATAGC -> CCCCTGAGACTCGAGGAGATAGCC
CATCTTGATTATCTGCGGCGTCGG -> ATCTTGATTATCTGCGGCGTCGGG
CCGACTACTCATCTTGATTATCTG -> CGACTACTCATCTTGATTATCTGC
GTTACAGATCCGGGCAAGTCTTCC -> TTACAGATCCGGGCAAGTCTTCCT
AATTATAATAAGCGAAATCGCGCC -> ATTATAATAAGCGAAATCGCGCCC
ATCAAGCATAGAGAAGGGTGTGGT -> TCAAGCATAGAGAAGGGTGTGGTC
ATATCACCGCTAAGTGGCCAATCT -> TATCACCGCTAAGTGGCCAATCTG
ACGGTAGCTTCCCATACGCAATCG -> CGGTAGCTTCCCATACGCAATCGA
GCCGAAAGCCCGACGGCCACTGTC -> CCGAAAGCCCGACGGCCACTGTCA
GTTGTGAACTGAGCAGCTGCGCCC -> TTGTGAACTGAGCAGCTGCGCCCG
AGTGCCACCCGCGGGAAACTCTAG -> GTGCCACCCGCGGGAAACTCTAGT
ACGATAGGCCTGTGGCCTGGGTAA -> CGATAGGCCTGTGGCCTGGGTAAC
TTAACTCCTGTGGTGTCCGCCAGA -> TAACTCCTGTGGTGTCCGCCAGAC
GACCTAAACCGAATTCAATTAGGC -> ACCTAAACCGAATTCAATTAGGCG
TATCGAAGATTGAGTTGCGGGGGT -> ATCGAAGATTGAGTTGCGGGGGTT
CCTTGCACGTGCCCAATTAGATGA -> CTTGCACGTGCCCAATTAGATGAT
GACTTACCTGTTATCGAAGATTGA -> ACTTACCTGTTATCGAAGATTGAG
CCCCTGAGACTCGAGGAGATAGCC -> CCCTGAGACTCGAGGAGATAGCCT
GGGGAGGCTTTCGTCGAATGAAGC -> GGGAGGCTTTCGTCGAATGAAGCG
CACGCCGCATTGCATCAGACTTAC -> ACGCCGCATTGCATCAGACTTACC
TGCGGTCACTCGTCTCCTCTCGGG -> GCGGTCACTCGTCTCCTCTCGGGT
CGTCGGGGGAGGCTTTCGTCGAAT -> GTCGGGGGAGGCTTTCGTCGAATG
GTCCAGTGCCTGCCTAGACATAGA -> TCCAGTGCCTGCCTAGACATAGAG
ATCGGACACGATCACGCGAGAAAC -> TCGGACACGATCACGCGAGAAACG
AAAGTTGTGTTCTGGATGTGAACG -> AAGTTGTGTTCTGGATGTGAACGG
CGACAAGGGCTTCTAACGCTGGCT -> GACAAGGGCTTCTAACGCTGGCTT
TCCCTTACAGTTCTCCACCTTGCG -> CCCTTACAGTTCTCCACCTTGCGA
GCCTCGGTTTGCGGAGGCTGGAAA -> CCTCGGTTTGCGGAGGCTGGAAAA
CTAGATTACAAGTTCCACGGGGGT -> TAGATTACAAGTTCCACGGGGGTG
AGACGCACAGACATTAGGGTTCAT -> GACGCACAGACATTAGGGTTCATG
GCCGGCAACTATCCCTTGCACGTG -> CCGGCAACTATCCCTTGCACGTGC
GCCAGACGCTAAACATGCCGACTA -> CCAGACGCTAAACATGCCGACTAC
CCTCGGTTTGCGGAGGCTGGAAAA -> CTCGGTTTGCGGAGGCTGGAAAAT
GAAAGCCCGACGGCCACTGTCACC -> AAAGCCCGACGGCCACTGTCACCC
TGGGGGTAGCCGAAAGCCCGACGG -> GGGGGTAGCCGAAAGCCCGACGGC
AATGTGAAACTTGAAGATTTCTGC -> ATGTGAAACTTGAAGATTTCTGCC
CGCCAGACGCTAAACATGCCGACT -> GCCAGACGCTAAACATGCCGACTA
ACTGAAGAGTTACAGATCCGGGCA -> CTGAAGAGTTACAGATCCGGGCAA
TCTCCTCTCGGGTTCGACTTTATT -> CTCCTCTCGGGTTCGACTTTATTC
ATTCAAATATCACCGCTAAGTGGC -> TTCAAATATCACCGCTAAGTGGCC
GCTCGAGGTTGAGCGAGCGCGAGT -> CTCGAGGTTGAGCGAGCGCGAGTG
GACCCGGTCGTGTGGCCGGCAACT -> ACCCGGTCGTGTGGCCGGCAACTA
ATCCCTTGCACGTGCCCAATTAGA -> TCCCTTGCACGTGCCCAATTAGAT
AGCTTCCCATACGCAATCGAGTTC -> GCTTCCCATACGCAATCGAGTTCG
TCGTCGAATGAAGCGCGTGTATGT -> CGTCGAATGAAGCGCGTGTATGTA
CTAGCGCATACCATACTTCAGCCA -> TAGCGCATACCATACTTCAGCCAA
ACGCACAGTTTGTTTACCATGGTT -> CGCACAGTTTGTTTACCATGGTTC
GGGTTCGACTTTATTCAAGTGAGG -> GGTTCGACTTTATTCAAGTGAGGG
TTGAGTTGCGGGGGTTTTCACCAG -> TGAGTTGCGGGGGTTTTCACCAGA
ACTGATGTAGAGGAGACCCCAATG -> CTGATGTAGAGGAGACCCCAATGA
GGAAACTCTAGTTTGCCCAAGCTC -> GAAACTCTAGTTTGCCCAAGCTCT
TCATGGTCTTTATTTTGTTGTTGC -> CATGGTCTTTATTTTGTTGTTGCG
CAATCGGACACGATCACGCGAGAA -> AATCGGACACGATCACGCGAGAAA
TGGATCCGAACACCACACGGAGTT -> GGATCCGAACACCACACGGAGTTG
GGGTAGAATTGAGAGCATGTCGAG -> GGTAGAATTGAGAGCATGTCGAGA
AGATTAAAAACACCGCCCGTAAGA -> GATTAAAAACACCGCCCGTAAGAT
CTTACCTGTTATCGAAGATTGAGT -> TTACCTGTTATCGAAGATTGAGTT
CACCACACGGAGTTGACCCAATGA -> ACCACACGGAGTTGACCCAATGAG
TAATAGTCCGTGAAGGGTCAGTAT -> AATAGTCCGTGAAGGGTCAGTATC
CATTTAAAGACTGCGATGGAATTA -> ATTTAAAGACTGCGATGGAATTAT
GTAGAGGAGACCCCAATGAAATGT -> TAGAGGAGACCCCAATGAAATGTA
CAAGATGGCCACGTATACGGTAGC -> AAGATGGCCACGTATACGGTAGCT
ACAAGGGCTTCTAACGCTGGCTTA -> CAAGGGCTTCTAACGCTGGCTTAA
GACGGACGATAGGCCTGTGGCCTG -> ACGGACGATAGGCCTGTGGCCTGG
GAGGAGACCCCAATGAAATGTATG -> AGGAGACCCCAATGAAATGTATGT
GTAGCGTAGTACAGTATTGTGAAG -> TAGCGTAGTACAGTATTGTGAAGA
TCGATCTAGCGTCTAGAGCACAAC -> CGATCTAGCGTCTAGAGCACAACT
GCGAGAAACGTTAAATTACCTGGG -> CGAGAAACGTTAAATTACCTGGGG
TGTTTACCATGGTTCGGGTGGCCG -> GTTTACCATGGTTCGGGTGGCCGT
CGCGGATGAGAACAATGTGAAACT -> GCGGATGAGAACAATGTGAAACTT
CTGTTAGGGTTGGATCCGAACACC -> TGTTAGGGTTGGATCCGAACACCA
ATAGAGACTGACGGACGATAGGCC -> TAGAGACTGACGGACGATAGGCCT
CCTCCCGTAACACATTCAAATATC -> CTCCCGTAACACATTCAAATATCA
TTATCGAAGATTGAGTTGCGGGGG -> TATCGAAGATTGAGTTGCGGGGGT
AATTCGATCTAGCGTCTAGAGCAC -> ATTCGATCTAGCGTCTAGAGCACA
CTTTGCTGATACATGCGGGCTTTA -> TTTGCTGATACATGCGGGCTTTAT
CGAATTCAATTAGGCGCAACAAAG -> GAATTCAATTAGGCGCAACAAAGA
TGTGGTCGAACAAGATGGCCACGT -> GTGGTCGAACAAGATGGCCACGTA
GGGACGGTACCAGCTAGGCAATCG -> GGACGGTACCAGCTAGGCAATCGG
GCCTTAGCGAGCGGTGGCGGATGT -> CCTTAGCGAGCGGTGGCGGATGTT
AATGTATGTATAAGTTGCGTCGTC -> ATGTATGTATAAGTTGCGTCGTCG
GGGGTTTTCACCAGACCTGTTAGG -> GGGTTTTCACCAGACCTGTTAGGG
CGCCGCATTGCATCAGACTTACCT -> GCCGCATTGCATCAGACTTACCTG
ACTAGAAATTGGACTACACATACG -> CTAGAAATTGGACTACACATACGT
AAATCAAGCATAGAGAAGGGTGTG -> AATCAAGCATAGAGAAGGGTGTGG
TCAATTCGATCTAGCGTCTAGAGC -> CAATTCGATCTAGCGTCTAGAGCA
CGGTACCAGCTAGGCAATCGGACA -> GGTACCAGCTAGGCAATCGGACAC
ATACGGTAGCTTCCCATACGCAAT -> TACGGTAGCTTCCCATACGCAATC
CCTATTCCTAAGCCGGATGTTCAA -> CTATTCCTAAGCCGGATGTTCAAT
GTCCCTCAGAGACAGTGCCAATTC -> TCCCTCAGAGACAGTGCCAATTCG
TTGACCCAATGAGAGCGCCTGTAG -> TGACCCAATGAGAGCGCCTGTAGG
TCAATTAGGCGCAACAAAGACATT -> CAATTAGGCGCAACAAAGACATTT
ATGCGGGCTTTATCAGACCTGACC -> TGCGGGCTTTATCAGACCTGACCT
CCCGTAACACATTCAAATATCACC -> CCGTAACACATTCAAATATCACCG
ATCTAGGCTCTAGGGGGCTAGCGC -> TCTAGGCTCTAGGGGGCTAGCGCA
TGCATCAGACTTACCTGTTATCGA -> GCATCAGACTTACCTGTTATCGAA
TCGCGCCCTCCCGTAACACATTCA -> CGCGCCCTCCCGTAACACATTCAA
GACATTTAAAGACTGCGATGGAAT -> ACATTTAAAGACTGCGATGGAATT
AGTGAGGGCCTGTGGCTACTCCAA -> GTGAGGGCCTGTGGCTACTCCAAC
CCCTTACAGTTCTCCACCTTGCGA -> CCTTACAGTTCTCCACCTTGCGAG
GTACCGCCTTAGCGAGCGGTGGCG -> TACCGCCTTAGCGAGCGGTGGCGG
CAGCCGTCGGAGATGCCGGTCCCT -> AGCCGTCGGAGATGCCGGTCCCTC
CAAGCATAGAGAAGGGTGTGGTCG -> AAGCATAGAGAAGGGTGTGGTCGA
CGAGGAGATAGCCTCGGTTTGCGG -> GAGGAGATAGCCTCGGTTTGCGGA
TGTTATCGAAGATTGAGTTGCGGG -> GTTATCGAAGATTGAGTTGCGGGG
TTATGTCAACGTCCCTTACAGTTC -> TATGTCAACGTCCCTTACAGTTCT
ATGCAGCCTACTGATGTAGAGGAG -> TGCAGCCTACTGATGTAGAGGAGA
GAACACCACACGGAGTTGACCCAA -> AACACCACACGGAGTTGACCCAAT
ACACCATTTTCAATCATATTGATC -> CACCATTTTCAATCATATTGATCC
TCGTACTGAACAGTTATCGTTTGC -> CGTACTGAACAGTTATCGTTTGCA
CGCCCTCCCGTAACACATTCAAAT -> GCCCTCCCGTAACACATTCAAATA
TGGAAAAAAAGTTGTGTTCTGGAT -> GGAAAAAAAGTTGTGTTCTGGATG
GCTAAACATGCCGACTACTCATCT -> CTAAACATGCCGACTACTCATCTT
TTACAAGTTCCACGGGGGTGGATC -> TACAAGTTCCACGGGGGTGGATCC
ACAAGATGGCCACGTATACGGTAG -> CAAGATGGCCACGTATACGGTAGC
CTTGGGGAAATTGCGGCTGCGGCC -> TTGGGGAAATTGCGGCTGCGGCCA
CCTCAGAGACAGTGCCAATTCGAT -> CTCAGAGACAGTGCCAATTCGATT
CGTAACACATTCAAATATCACCGC -> GTAACACATTCAAATATCACCGCT
GCCCTAATTGACTAGAAATTGGAC -> CCCTAATTGACTAGAAATTGGACT
CGGGGCCCCTGAGACTCGAGGAGA -> GGGGCCCCTGAGACTCGAGGAGAT
ATCCTGGCTTTACGCGCATTAGAT -> TCCTGGCTTTACGCGCATTAGATC
TCCCGGGCTGCTTAAGACTCAATC -> CCCGGGCTGCTTAAGACTCAATCT
TGTGAAACTTGAAGATTTCTGCCC -> GTGAAACTTGAAGATTTCTGCCCT
ACACGATCACGCGAGAAACGTTAA -> CACGATCACGCGAGAAACGTTAAA
GTGCCACCCGCGGGAAACTCTAGT -> TGCCACCCGCGGGAAACTCTAGTT
TTCGATTCGATAACTAAGGTGGGA -> TCGATTCGATAACTAAGGTGGGAA
CATTTGCTGCATGCTCTGACAGCC -> ATTTGCTGCATGCTCTGACAGCCC
CGTCTCCTCTCGGGTTCGACTTTA -> GTCTCCTCTCGGGTTCGACTTTAT
TAGACATAGAGACTGACGGACGAT -> AGACATAGAGACTGACGGACGATA
GGCCACTGTCACCCTCCCGTCCAG -> GCCACTGTCACCCTCCCGTCCAGT
ACTACTCATCTTGATTATCTGCGG -> CTACTCATCTTGATTATCTGCGGC
AAAATTCCGGCCATGTAGCGTAGT -> AAATTCCGGCCATGTAGCGTAGTA
CTGCGGCCAAGGCTCTGTTAGGGC -> TGCGGCCAAGGCTCTGTTAGGGCT
CGGCTACAGCGAGCGGAAATGGGC -> GGCTACAGCGAGCGGAAATGGGCG
CAGGGTTCATTCGCGTCACGCCGC -> AGGGTTCATTCGCGTCACGCCGCA
TTCGCTATGGAAAAAAAGTTGTGT -> TCGCTATGGAAAAAAAGTTGTGTT
CGGTCCCTCAGAGACAGTGCCAAT -> GGTCCCTCAGAGACAGTGCCAATT
ATGAGAGCGCCTGTAGGCAGCGTA -> TGAGAGCGCCTGTAGGCAGCGTAC
AATTAGGCGCAACAAAGACATTTA -> ATTAGGCGCAACAAAGACATTTAA
CCATACTTCAGCCAATTGGAGCAC -> CATACTTCAGCCAATTGGAGCACA
CGAGCGGAAATGGGCGGGTAGAAT -> GAGCGGAAATGGGCGGGTAGAATT
CGAAATCGCGCCCTCCCGTAACAC -> GAAATCGCGCCCTCCCGTAACACA
AGGCCGACGTTTCGCTATGGAAAA -> GGCCGACGTTTCGCTATGGAAAAA
CAATGAGAGCGCCTGTAGGCAGCG -> AATGAGAGCGCCTGTAGGCAGCGT
AGTGGCCAATCTGAGTCGTCGTGT -> GTGGCCAATCTGAGTCGTCGTGTA
TAAATTACCTGGGGCCCGGGGGTA -> AAATTACCTGGGGCCCGGGGGTAG
TCAGTAGGTTTAGCCTACCATCAT -> CAGTAGGTTTAGCCTACCATCATG
AAATGTATGTATAAGTTGCGTCGT -> AATGTATGTATAAGTTGCGTCGTC
GGGTTTTCACCAGACCTGTTAGGG -> GGTTTTCACCAGACCTGTTAGGGT
ATCACTCAGTAGGTTTAGCCTACC -> TCACTCAGTAGGTTTAGCCTACCA
CCAATGAAATGTATGTATAAGTTG -> CAATGAAATGTATGTATAAGTTGC
GCTGGAGGCCGACGTTTCGCTATG -> CTGGAGGCCGACGTTTCGCTATGG
TCTAGGCTCTAGGGGGCTAGCGCA -> CTAGGCTCTAGGGGGCTAGCGCAT
CATCATGCAGCCTACTGATGTAGA -> ATCATGCAGCCTACTGATGTAGAG
CTCCTCTCGGGTTCGACTTTATTC -> TCCTCTCGGGTTCGACTTTATTCA
TAAGTGGCCAATCTGAGTCGTCGT -> AAGTGGCCAATCTGAGTCGTCGTG
CCTGGGGCCCGGGGGTAGCCTCCG -> CTGGGGCCCGGGGGTAGCCTCCGT
ATGGCCACGTATACGGTAGCTTCC -> TGGCCACGTATACGGTAGCTTCCC
GCTGGAAAATTCCGGCCATGTAGC -> CTGGAAAATTCCGGCCATGTAGCG
TACAGCGAGCGGAAATGGGCGGGT -> ACAGCGAGCGGAAATGGGCGGGTA
GAAATGGGCGGGTAGAATTGAGAG -> AAATGGGCGGGTAGAATTGAGAGC
CGAGCGGTGGCGGATGTTAGACTC -> GAGCGGTGGCGGATGTTAGACTCT
GACGTTTCGCTATGGAAAAAAAGT -> ACGTTTCGCTATGGAAAAAAAGTT
GCTGCATGCTCTGACAGCCCAATC -> CTGCATGCTCTGACAGCCCAATCT
CCATGGTTCGGGTGGCCGTTATCC -> CATGGTTCGGGTGGCCGTTATCCC
AAAAACACCGCCCGTAAGATGGGA -> AAAACACCGCCCGTAAGATGGGAC
AGGTGGGAACATCAGACAGAAACT -> GGTGGGAACATCAGACAGAAACTC
GTAGGTTTAGCCTACCATCATGCA -> TAGGTTTAGCCTACCATCATGCAG
CATGTAGCGTAGTACAGTATTGTG -> ATGTAGCGTAGTACAGTATTGTGA
GAAATGTATGTATAAGTTGCGTCG -> AAATGTATGTATAAGTTGCGTCGT
TAGCCTCGGTTTGCGGAGGCTGGA -> AGCCTCGGTTTGCGGAGGCTGGAA
GAGGCCGACGTTTCGCTATGGAAA -> AGGCCGACGTTTCGCTATGGAAAA
ATGGTTCGGGTGGCCGTTATCCCA -> TGGTTCGGGTGGCCGTTATCCCAC
GGTCGAACAAGATGGCCACGTATA -> GTCGAACAAGATGGCCACGTATAC
AGGCTGGAAAATTCCGGCCATGTA -> GGCTGGAAAATTCCGGCCATGTAG
TAGCGTCTAGAGCACAACTTTTCA -> AGCGTCTAGAGCACAACTTTTCAC
GCGTAGTACAGTATTGTGAAGACC -> CGTAGTACAGTATTGTGAAGACCC
TGCGGCGTCGGGGGAGGCTTTCGT -> GCGGCGTCGGGGGAGGCTTTCGTC
ATCTAGCGTCTAGAGCACAACTTT -> TCTAGCGTCTAGAGCACAACTTTT
GTATACGGTAGCTTCCCATACGCA -> TATACGGTAGCTTCCCATACGCAA
ACGCTGGCTTAACTCCTGTGGTGT -> CGCTGGCTTAACTCCTGTGGTGTC
CGGCTTATGGGGGTAGCCGAAAGC -> GGCTTATGGGGGTAGCCGAAAGCC
CCGGCCATGTAGCGTAGTACAGTA -> CGGCCATGTAGCGTAGTACAGTAT
GTGAACGGTCTTTCCCTATTCCTA -> TGAACGGTCTTTCCCTATTCCTAA
CTATGGAAAAAAAGTTGTGTTCTG -> TATGGAAAAAAAGTTGTGTTCTGG
GGGGCCGGCTAGTTCAGGGTTCAT -> GGGCCGGCTAGTTCAGGGTTCATT
TTCCTAGATGTCGGATCTTTCAGA -> TCCTAGATGTCGGATCTTTCAGAA
CAGTTCTCCACCTTGCGAGCGATT -> AGTTCTCCACCTTGCGAGCGATTA
TTGCGGTCACTCGTCTCCTCTCGG -> TGCGGTCACTCGTCTCCTCTCGGG
CTTTATCAGACCTGACCTAAACCG -> TTTATCAGACCTGACCTAAACCGA
GTCGGGCCATTTGCTGCATGCTCT -> TCGGGCCATTTGCTGCATGCTCTG
TCGGGCCATTTGCTGCATGCTCTG -> CGGGCCATTTGCTGCATGCTCTGA
AGTTTGTTTACCATGGTTCGGGTG -> GTTTGTTTACCATGGTTCGGGTGG
TTGGAGCACACCATTTTCAATCAT -> TGGAGCACACCATTTTCAATCATA
AGCCCAATCTAGGCTCTAGGGGGC -> GCCCAATCTAGGCTCTAGGGGGCT
ACAGAAACTCGGATGAACCGCTGG -> CAGAAACTCGGATGAACCGCTGGA
CTAGATGTCGGATCTTTCAGAAAC -> TAGATGTCGGATCTTTCAGAAACT
GTGCCTCCCGGGGCCCCTGAGACT -> TGCCTCCCGGGGCCCCTGAGACTC
TGTGTAGGGAACATGCAGCTGAAG -> GTGTAGGGAACATGCAGCTGAAGC
GGGTTGGATCCGAACACCACACGG -> GGTTGGATCCGAACACCACACGGA
TCCGGCCATGTAGCGTAGTACAGT -> CCGGCCATGTAGCGTAGTACAGTA
ATTGACTAGAAATTGGACTACACA -> TTGACTAGAAATTGGACTACACAT
ACCATGGTTCGGGTGGCCGTTATC -> CCATGGTTCGGGTGGCCGTTATCC
AGCGTAGTACAGTATTGTGAAGAC -> GCGTAGTACAGTATTGTGAAGACC
CAGCTAGGCAATCGGACACGATCA -> AGCTAGGCAATCGGACACGATCAC
CTGACAGCCCAATCTAGGCTCTAG -> TGACAGCCCAATCTAGGCTCTAGG
CTAACGCTGGCTTAACTCCTGTGG -> TAACGCTGGCTTAACTCCTGTGGT
GGTTTGCGGAGGCTGGAAAATTCC -> GTTTGCGGAGGCTGGAAAATTCCG
ATGTTCAATGGTGAGCGTTATGTC -> TGTTCAATGGTGAGCGTTATGTCA
GACCCAATGAGAGCGCCTGTAGGC -> ACCCAATGAGAGCGCCTGTAGGCA
CCCGTAAGATGGGACGGTACCAGC -> CCGTAAGATGGGACGGTACCAGCT
AATTGACTAGAAATTGGACTACAC -> ATTGACTAGAAATTGGACTACACA
CCCATACGCAATCGAGTTCGTACT -> CCATACGCAATCGAGTTCGTACTG
TCTTGATTATCTGCGGCGTCGGGG -> CTTGATTATCTGCGGCGTCGGGGG
TCGTTGTGAACTGAGCAGCTGCGC -> CGTTGTGAACTGAGCAGCTGCGCC
CAGACAGAAACTCGGATGAACCGC -> AGACAGAAACTCGGATGAACCGCT
TCACGCCGCATTGCATCAGACTTA -> CACGCCGCATTGCATCAGACTTAC
CTAGAAATTGGACTACACATACGT -> TAGAAATTGGACTACACATACGTG
TGCTATGTCGACAAGGGCTTCTAA -> GCTATGTCGACAAGGGCTTCTAAC
GTAACGTAGACGCACAGACATTAG -> TAACGTAGACGCACAGACATTAGG
GTGAGCGTTATGTCAACGTCCCTT -> TGAGCGTTATGTCAACGTCCCTTA
TACCTAATAGTCCGTGAAGGGTCA -> ACCTAATAGTCCGTGAAGGGTCAG
GGATGTTCAATGGTGAGCGTTATG -> GATGTTCAATGGTGAGCGTTATGT
GGGCTTTATCAGACCTGACCTAAA -> GGCTTTATCAGACCTGACCTAAAC
TATTCCTAAGCCGGATGTTCAATG -> ATTCCTAAGCCGGATGTTCAATGG
GGAGATAGCCTCGGTTTGCGGAGG -> GAGATAGCCTCGGTTTGCGGAGGC
GTTCAATGGTGAGCGTTATGTCAA -> TTCAATGGTGAGCGTTATGTCAAC
CGTCTAGAGCACAACTTTTCACCG -> GTCTAGAGCACAACTTTTCACCGG
TAGCCTCCGTGCCTCCCGGGGCCC -> AGCCTCCGTGCCTCCCGGGGCCCC
TGTGGCCTGGGTAACCTAACGGGG -> GTGGCCTGGGTAACCTAACGGGGC
GAGAGATTAAAAACACCGCCCGTA -> AGAGATTAAAAACACCGCCCGTAA
AGCCTACTGATGTAGAGGAGACCC -> GCCTACTGATGTAGAGGAGACCCC
GATCCGGGCAAGTCTTCCTAGATG -> ATCCGGGCAAGTCTTCCTAGATGT
TCGCTATGGAAAAAAAGTTGTGTT -> CGCTATGGAAAAAAAGTTGTGTTC
GAGCGATTACCTAATAGTCCGTGA -> AGCGATTACCTAATAGTCCGTGAA
GCTAGTTCAGGGTTCATTCGCGTC -> CTAGTTCAGGGTTCATTCGCGTCA
GGAATTATAATAAGCGAAATCGCG -> GAATTATAATAAGCGAAATCGCGC
TGACGGACGATAGGCCTGTGGCCT -> GACGGACGATAGGCCTGTGGCCTG
GCACAACTTTTCACCGGGACTCCG -> CACAACTTTTCACCGGGACTCCGG
GGTGGCCGTTATCCCACCAATCAC -> GTGGCCGTTATCCCACCAATCACA
GTCGGATCTTTCAGAAACTCAGTG -> TCGGATCTTTCAGAAACTCAGTGC
GAGTGCTATGTCGACAAGGGCTTC -> AGTGCTATGTCGACAAGGGCTTCT
TCGCGGATGAGAACAATGTGAAAC -> CGCGGATGAGAACAATGTGAAACT
CTGGCTTTACGCGCATTAGATCGT -> TGGCTTTACGCGCATTAGATCGTT
GATTAAAAACACCGCCCGTAAGAT -> ATTAAAAACACCGCCCGTAAGATG
CGCATTGCATCAGACTTACCTGTT -> GCATTGCATCAGACTTACCTGTTA
AAAACACCGCCCGTAAGATGGGAC -> AAACACCGCCCGTAAGATGGGACG
CGTCGTGGGTGCTCGTACCGCCTT -> GTCGTGGGTGCTCGTACCGCCTTA
TGTTGTTGCGGTCACTCGTCTCCT -> GTTGTTGCGGTCACTCGTCTCCTC
CAGACCTGTTAGGGTTGGATCCGA -> AGACCTGTTAGGGTTGGATCCGAA
CATTAGATCGTTGTGAACTGAGCA -> ATTAGATCGTTGTGAACTGAGCAG
ACCGAATTCAATTAGGCGCAACAA -> CCGAATTCAATTAGGCGCAACAAA
CCGGGGCCCCTGAGACTCGAGGAG -> CGGGGCCCCTGAGACTCGAGGAGA
ACGCAATCGAGTTCGTACTGAACA -> CGCAATCGAGTTCGTACTGAACAG
GGATCTTTCAGAAACTCAGTGCCA -> GATCTTTCAGAAACTCAGTGCCAC
TAGGGCTCGAGGTTGAGCGAGCGC -> AGGGCTCGAGGTTGAGCGAGCGCG
AGACTTACCTGTTATCGAAGATTG -> GACTTACCTGTTATCGAAGATTGA
GGGCCTGTGGCTACTCCAACGCAC -> GGCCTGTGGCTACTCCAACGCACA
CGGTCGTGTGGCCGGCAACTATCC -> GGTCGTGTGGCCGGCAACTATCCC
AACAAGATGGCCACGTATACGGTA -> ACAAGATGGCCACGTATACGGTAG
CTTATGGGGGTAGCCGAAAGCCCG -> TTATGGGGGTAGCCGAAAGCCCGA
AATTCAATTAGGCGCAACAAAGAC -> ATTCAATTAGGCGCAACAAAGACA
TGTATAAGTTGCGTCGTCGTGGGT -> GTATAAGTTGCGTCGTCGTGGGTG
ACGCGCATTAGATCGTTGTGAACT -> CGCGCATTAGATCGTTGTGAACTG
TCCTGGCTTTACGCGCATTAGATC -> CCTGGCTTTACGCGCATTAGATCG
TTCATTCGCGTCACGCCGCATTGC -> TCATTCGCGTCACGCCGCATTGCA
CTGAGCAGCTGCGCCCGGCTACAG -> TGAGCAGCTGCGCCCGGCTACAGC
GACTCTAGATTACAAGTTCCACGG -> ACTCTAGATTACAAGTTCCACGGG
GGAACATCAGACAGAAACTCGGAT -> GAACATCAGACAGAAACTCGGATG
GCCACTGTCACCCTCCCGTCCAGT -> CCACTGTCACCCTCCCGTCCAGTG
CAATGGTGAGCGTTATGTCAACGT -> AATGGTGAGCGTTATGTCAACGTC
ATGGTGAGCGTTATGTCAACGTCC -> TGGTGAGCGTTATGTCAACGTCCC
GCCCGGGGGTAGCCTCCGTGCCTC -> CCCGGGGGTAGCCTCCGTGCCTCC
CGTGCCCAATTAGATGATCACTGA -> GTGCCCAATTAGATGATCACTGAA
GCGAGCGGAAATGGGCGGGTAGAA -> CGAGCGGAAATGGGCGGGTAGAAT
GGGTAGCCTCCGTGCCTCCCGGGG -> GGTAGCCTCCGTGCCTCCCGGGGC
CAATTGGAGCACACCATTTTCAAT -> AATTGGAGCACACCATTTTCAATC
GGGTAACCTAACGGGGCCGGCTAG -> GGTAACCTAACGGGGCCGGCTAGT
TGTCGAGAGATTAAAAACACCGCC -> GTCGAGAGATTAAAAACACCGCCC
TGCCCAAGCTCTTGGGGAAATTGC -> GCCCAAGCTCTTGGGGAAATTGCG
GCCAATTCGATTCGATAACTAAGG -> CCAATTCGATTCGATAACTAAGGT
TACAGAAAATCAAGCATAGAGAAG -> ACAGAAAATCAAGCATAGAGAAGG
GTGAAGACCCGGTCGTGTGGCCGG -> TGAAGACCCGGTCGTGTGGCCGGC
TGTATGTATAAGTTGCGTCGTCGT -> GTATGTATAAGTTGCGTCGTCGTG
GCTAAGTGGCCAATCTGAGTCGTC -> CTAAGTGGCCAATCTGAGTCGTCG
ATGGTCTTTATTTTGTTGTTGCGG -> TGGTCTTTATTTTGTTGTTGCGGT
GGTCGTGTGGCCGGCAACTATCCC -> GTCGTGTGGCCGGCAACTATCCCT
TTTCACCAGACCTGTTAGGGTTGG -> TTCACCAGACCTGTTAGGGTTGGA
ATTGAGAGCATGTCGAGAGATTAA -> TTGAGAGCATGTCGAGAGATTAAA
GTCGAATGAAGCGCGTGTATGTAA -> TCGAATGAAGCGCGTGTATGTAAC
GACGGCCACTGTCACCCTCCCGTC -> ACGGCCACTGTCACCCTCCCGTCC
TGGAATTATAATAAGCGAAATCGC -> GGAATTATAATAAGCGAAATCGCG
AGCCTCCGTGCCTCCCGGGGCCCC -> GCCTCCGTGCCTCCCGGGGCCCCT
TACCGCCTTAGCGAGCGGTGGCGG -> ACCGCCTTAGCGAGCGGTGGCGGA
TTATCGTTTGCAGCCGTCGGAGAT -> TATCGTTTGCAGCCGTCGGAGATG
ACAACTTTTCACCGGGACTCCGGC -> CAACTTTTCACCGGGACTCCGGCT
GTCGACAAGGGCTTCTAACGCTGG -> TCGACAAGGGCTTCTAACGCTGGC
AGGTTGAGCGAGCGCGAGTGCTAT -> GGTTGAGCGAGCGCGAGTGCTATG
GGACGATAGGCCTGTGGCCTGGGT -> GACGATAGGCCTGTGGCCTGGGTA
GGCTAGCGCATACCATACTTCAGC -> GCTAGCGCATACCATACTTCAGCC
AGGCAGCGTACAGAAAATCAAGCA -> GGCAGCGTACAGAAAATCAAGCAT
AGTTGCGGGGGTTTTCACCAGACC -> GTTGCGGGGGTTTTCACCAGACCT
TTCAGGGTTCATTCGCGTCACGCC -> TCAGGGTTCATTCGCGTCACGCCG
ATTCGATCTAGCGTCTAGAGCACA -> TTCGATCTAGCGTCTAGAGCACAA
CGTCGTGTATCACTCAGTAGGTTT -> GTCGTGTATCACTCAGTAGGTTTA
GGAGGCTGGAAAATTCCGGCCATG -> GAGGCTGGAAAATTCCGGCCATGT
CATGCCGACTACTCATCTTGATTA -> ATGCCGACTACTCATCTTGATTAT
TGCCGGTCCCTCAGAGACAGTGCC -> GCCGGTCCCTCAGAGACAGTGCCA
GGTAACCTAACGGGGCCGGCTAGT -> GTAACCTAACGGGGCCGGCTAGTT
AATCGGACACGATCACGCGAGAAA -> ATCGGACACGATCACGCGAGAAAC
GCAGCTGCGCCCGGCTACAGCGAG -> CAGCTGCGCCCGGCTACAGCGAGC
TTACAGTTCTCCACCTTGCGAGCG -> TACAGTTCTCCACCTTGCGAGCGA
TAGCTTCCCATACGCAATCGAGTT -> AGCTTCCCATACGCAATCGAGTTC
TAAACATGCCGACTACTCATCTTG -> AAACATGCCGACTACTCATCTTGA
CCACCCGCGGGAAACTCTAGTTTG -> CACCCGCGGGAAACTCTAGTTTGC
AAATTGCGGCTGCGGCCAAGGCTC -> AATTGCGGCTGCGGCCAAGGCTCT
AACCGCTGGAGGCCGACGTTTCGC -> ACCGCTGGAGGCCGACGTTTCGCT
TCAAATATCACCGCTAAGTGGCCA -> CAAATATCACCGCTAAGTGGCCAA
TTGCTGATACATGCGGGCTTTATC -> TGCTGATACATGCGGGCTTTATCA
ATTTTCAATCATATTGATCCTGGC -> TTTTCAATCATATTGATCCTGGCT
CCAATCACAGCATGTTCAATTCGA -> CAATCACAGCATGTTCAATTCGAT
CTTCAGCCAATTGGAGCACACCAT -> TTCAGCCAATTGGAGCACACCATT
GAGCGTTATGTCAACGTCCCTTAC -> AGCGTTATGTCAACGTCCCTTACA
TCCCATACGCAATCGAGTTCGTAC -> CCCATACGCAATCGAGTTCGTACT
ACCACACGGAGTTGACCCAATGAG -> CCACACGGAGTTGACCCAATGAGA
CCTCTCGGGTTCGACTTTATTCAA -> CTCTCGGGTTCGACTTTATTCAAG
TCTGGATGTGAACGGTCTTTCCCT -> CTGGATGTGAACGGTCTTTCCCTA
GGTGGATCCCGGGCTGCTTAAGAC -> GTGGATCCCGGGCTGCTTAAGACT
GGCTCTGTTAGGGCTCGAGGTTGA -> GCTCTGTTAGGGCTCGAGGTTGAG
GAGTTACAGATCCGGGCAAGTCTT -> AGTTACAGATCCGGGCAAGTCTTC
GCATGTCGAGAGATTAAAAACACC -> CATGTCGAGAGATTAAAAACACCG
CCAGACGCTAAACATGCCGACTAC -> CAGACGCTAAACATGCCGACTACT
GTTTGCCCAAGCTCTTGGGGAAAT -> TTTGCCCAAGCTCTTGGGGAAATT
AACGGTCTTTCCCTATTCCTAAGC -> ACGGTCTTTCCCTATTCCTAAGCC
GTATCGCGGATGAGAACAATGTGA -> TATCGCGGATGAGAACAATGTGAA
CCATGTAGCGTAGTACAGTATTGT -> CATGTAGCGTAGTACAGTATTGTG
TAGAATTGAGAGCATGTCGAGAGA -> AGAATTGAGAGCATGTCGAGAGAT
TGTCGACAAGGGCTTCTAACGCTG -> GTCGACAAGGGCTTCTAACGCTGG
CACCAATCACAGCATGTTCAATTC -> ACCAATCACAGCATGTTCAATTCG
AGGGTTCATGGTCTTTATTTTGTT -> GGGTTCATGGTCTTTATTTTGTTG
AATTACCTGGGGCCCGGGGGTAGC -> ATTACCTGGGGCCCGGGGGTAGCC
TATCGCGGATGAGAACAATGTGAA -> ATCGCGGATGAGAACAATGTGAAA
AAAAAAAGTTGTGTTCTGGATGTG -> AAAAAAGTTGTGTTCTGGATGTGA
AGACTCGAGGAGATAGCCTCGGTT -> GACTCGAGGAGATAGCCTCGGTTT
AGGCAATCGGACACGATCACGCGA -> GGCAATCGGACACGATCACGCGAG
GCGTACAGAAAATCAAGCATAGAG -> CGTACAGAAAATCAAGCATAGAGA
GAGTTCGTACTGAACAGTTATCGT -> AGTTCGTACTGAACAGTTATCGTT
TAAGTTGCGTCGTCGTGGGTGCTC -> AAGTTGCGTCGTCGTGGGTGCTCG
GTTTCGCTATGGAAAAAAAGTTGT -> TTTCGCTATGGAAAAAAAGTTGTG
AGCCGAAAGCCCGACGGCCACTGT -> GCCGAAAGCCCGACGGCCACTGTC
ATATTGATCCTGGCTTTACGCGCA -> TATTGATCCTGGCTTTACGCGCAT
TGTAGCGTAGTACAGTATTGTGAA -> GTAGCGTAGTACAGTATTGTGAAG
GCGGATGAGAACAATGTGAAACTT -> CGGATGAGAACAATGTGAAACTTG
CTAGGCTCTAGGGGGCTAGCGCAT -> TAGGCTCTAGGGGGCTAGCGCATA
AGTTCGTACTGAACAGTTATCGTT -> GTTCGTACTGAACAGTTATCGTTT
TCACTCGTCTCCTCTCGGGTTCGA -> CACTCGTCTCCTCTCGGGTTCGAC
AAACTCTAGTTTGCCCAAGCTCTT -> AACTCTAGTTTGCCCAAGCTCTTG
GGCGGATGTTAGACTCTAGATTAC -> GCGGATGTTAGACTCTAGATTACA
CACGCGAGAAACGTTAAATTACCT -> ACGCGAGAAACGTTAAATTACCTG
ATAGTCCGTGAAGGGTCAGTATCG -> TAGTCCGTGAAGGGTCAGTATCGC
CAACTATCCCTTGCACGTGCCCAA -> AACTATCCCTTGCACGTGCCCAAT
CCGTAAGATGGGACGGTACCAGCT -> CGTAAGATGGGACGGTACCAGCTA
TTTATCAGACCTGACCTAAACCGA -> TTATCAGACCTGACCTAAACCGAA
TGTAGAGGAGACCCCAATGAAATG -> GTAGAGGAGACCCCAATGAAATGT
CACAGTTTGTTTACCATGGTTCGG -> ACAGTTTGTTTACCATGGTTCGGG
CTCCACCTTGCGAGCGATTACCTA -> TCCACCTTGCGAGCGATTACCTAA
AGACCTGACCTAAACCGAATTCAA -> GACCTGACCTAAACCGAATTCAAT
CAATCTGAGTCGTCGTGTATCACT -> AATCTGAGTCGTCGTGTATCACTC
TGCAGCTGAAGCGTCGGGCCATTT -> GCAGCTGAAGCGTCGGGCCATTTG
TAGTCCGTGAAGGGTCAGTATCGC -> AGTCCGTGAAGGGTCAGTATCGCG
GAACGGTCTTTCCCTATTCCTAAG -> AACGGTCTTTCCCTATTCCTAAGC
TAGCCGAAAGCCCGACGGCCACTG -> AGCCGAAAGCCCGACGGCCACTGT
CGTTATCCCACCAATCACAGCATG -> GTTATCCCACCAATCACAGCATGT
GGTCTTTCCCTATTCCTAAGCCGG -> GTCTTTCCCTATTCCTAAGCCGGA
TGAAGACCCGGTCGTGTGGCCGGC -> GAAGACCCGGTCGTGTGGCCGGCA
TTTGCTGATACATGCGGGCTTTAT -> TTGCTGATACATGCGGGCTTTATC
CTACTCATCTTGATTATCTGCGGC -> TACTCATCTTGATTATCTGCGGCG
AGTTACAGATCCGGGCAAGTCTTC -> GTTACAGATCCGGGCAAGTCTTCC
TAGGGGGCTAGCGCATACCATACT -> AGGGGGCTAGCGCATACCATACTT
ATTCGCGTCACGCCGCATTGCATC -> TTCGCGTCACGCCGCATTGCATCA
GCGTCTAGAGCACAACTTTTCACC -> CGTCTAGAGCACAACTTTTCACCG
GTTAGACTCTAGATTACAAGTTCC -> TTAGACTCTAGATTACAAGTTCCA
TCCCGTAACACATTCAAATATCAC -> CCCGTAACACATTCAAATATCACC
GAACCGCTGGAGGCCGACGTTTCG -> AACCGCTGGAGGCCGACGTTTCGC
AGTCCGTGAAGGGTCAGTATCGCG -> GTCCGTGAAGGGTCAGTATCGCGG
AGACTCTAGATTACAAGTTCCACG -> GACTCTAGATTACAAGTTCCACGG
GCCTACTGATGTAGAGGAGACCCC -> CCTACTGATGTAGAGGAGACCCCA
TGTTCAATGGTGAGCGTTATGTCA -> GTTCAATGGTGAGCGTTATGTCAA
CGCTATGGAAAAAAAGTTGTGTTC -> GCTATGGAAAAAAAGTTGTGTTCT
CTAAGCCGGATGTTCAATGGTGAG -> TAAGCCGGATGTTCAATGGTGAGC
GGCAACTATCCCTTGCACGTGCCC -> GCAACTATCCCTTGCACGTGCCCA
TAGGTTTAGCCTACCATCATGCAG -> AGGTTTAGCCTACCATCATGCAGC
GAATTATAATAAGCGAAATCGCGC -> AATTATAATAAGCGAAATCGCGCC
CCACGTATACGGTAGCTTCCCATA -> CACGTATACGGTAGCTTCCCATAC
AGCGAGCGGTGGCGGATGTTAGAC -> GCGAGCGGTGGCGGATGTTAGACT
CTTTTCACCGGGACTCCGGCTTTG -> TTTTCACCGGGACTCCGGCTTTGC
AGCATAGAGAAGGGTGTGGTCGAA -> GCATAGAGAAGGGTGTGGTCGAAC
TCCAACGCACAGTTTGTTTACCAT -> CCAACGCACAGTTTGTTTACCATG
CCCAATGAGAGCGCCTGTAGGCAG -> CCAATGAGAGCGCCTGTAGGCAGC
TCTTTCAGAAACTCAGTGCCACCC -> CTTTCAGAAACTCAGTGCCACCCG
GGCGGGTAGAATTGAGAGCATGTC -> GCGGGTAGAATTGAGAGCATGTCG
AGACTGACGGACGATAGGCCTGTG -> GACTGACGGACGATAGGCCTGTGG
GGTGAGCGTTATGTCAACGTCCCT -> GTGAGCGTTATGTCAACGTCCCTT
GTTCTCCACCTTGCGAGCGATTAC -> TTCTCCACCTTGCGAGCGATTACC
TAAGCGAAATCGCGCCCTCCCGTA -> AAGCGAAATCGCGCCCTCCCGTAA
AAGACCCGGTCGTGTGGCCGGCAA -> AGACCCGGTCGTGTGGCCGGCAAC
ACCCCAATGAAATGTATGTATAAG -> CCCCAATGAAATGTATGTATAAGT
TAGAGCACAACTTTTCACCGGGAC -> AGAGCACAACTTTTCACCGGGACT
GGATGTGAACGGTCTTTCCCTATT -> GATGTGAACGGTCTTTCCCTATTC
CTGTGGTGTCCGCCAGACGCTAAA -> TGTGGTGTCCGCCAGACGCTAAAC
GGTTCATTCGCGTCACGCCGCATT -> GTTCATTCGCGTCACGCCGCATTG
GTGGCCGGCAACTATCCCTTGCAC -> TGGCCGGCAACTATCCCTTGCACG
GTCGTGTATCACTCAGTAGGTTTA -> TCGTGTATCACTCAGTAGGTTTAG
ATCAGACCTGACCTAAACCGAATT -> TCAGACCTGACCTAAACCGAATTC
TACTTCAGCCAATTGGAGCACACC -> ACTTCAGCCAATTGGAGCACACCA
TAGACGCACAGACATTAGGGTTCA -> AGACGCACAGACATTAGGGTTCAT
CTAGGGGGCTAGCGCATACCATAC -> TAGGGGGCTAGCGCATACCATACT
TGGCCTGGGTAACCTAACGGGGCC -> GGCCTGGGTAACCTAACGGGGCCG
GGCGTCGGGGGAGGCTTTCGTCGA -> GCGTCGGGGGAGGCTTTCGTCGAA
ATTGGAGCACACCATTTTCAATCA -> TTGGAGCACACCATTTTCAATCAT
GCCGACTACTCATCTTGATTATCT -> CCGACTACTCATCTTGATTATCTG
ATTACCTGGGGCCCGGGGGTAGCC -> TTACCTGGGGCCCGGGGGTAGCCT
CAATTCGATCTAGCGTCTAGAGCA -> AATTCGATCTAGCGTCTAGAGCAC
CGGGTAGAATTGAGAGCATGTCGA -> GGGTAGAATTGAGAGCATGTCGAG
CGGGGGAGGCTTTCGTCGAATGAA -> GGGGGAGGCTTTCGTCGAATGAAG
AAGACATTTAAAGACTGCGATGGA -> AGACATTTAAAGACTGCGATGGAA
ATGAGAACAATGTGAAACTTGAAG -> TGAGAACAATGTGAAACTTGAAGA
TGATCCTGGCTTTACGCGCATTAG -> GATCCTGGCTTTACGCGCATTAGA
AACTCTAGTTTGCCCAAGCTCTTG -> ACTCTAGTTTGCCCAAGCTCTTGG
TTCAGAAACTCAGTGCCACCCGCG -> TCAGAAACTCAGTGCCACCCGCGG
ATTTTGTTGTTGCGGTCACTCGTC -> TTTTGTTGTTGCGGTCACTCGTCT
ACATGCAGCTGAAGCGTCGGGCCA -> CATGCAGCTGAAGCGTCGGGCCAT
TATGTCAACGTCCCTTACAGTTCT -> ATGTCAACGTCCCTTACAGTTCTC
GCTAGCGCATACCATACTTCAGCC -> CTAGCGCATACCATACTTCAGCCA
CACTGAAGAGTTACAGATCCGGGC -> ACTGAAGAGTTACAGATCCGGGCA
TAGGCAGCGTACAGAAAATCAAGC -> AGGCAGCGTACAGAAAATCAAGCA
TCGAATGAAGCGCGTGTATGTAAC -> CGAATGAAGCGCGTGTATGTAACG
CAGACGCTAAACATGCCGACTACT -> AGACGCTAAACATGCCGACTACTC
TGTGGCCGGCAACTATCCCTTGCA -> GTGGCCGGCAACTATCCCTTGCAC
CGCTGGAGGCCGACGTTTCGCTAT -> GCTGGAGGCCGACGTTTCGCTATG
ACGGGGGTGGATCCCGGGCTGCTT -> CGGGGGTGGATCCCGGGCTGCTTA
AATTAGATGATCACTGAAGAGTTA -> ATTAGATGATCACTGAAGAGTTAC
GCAACAAAGACATTTAAAGACTGC -> CAACAAAGACATTTAAAGACTGCG
TCCTAAGCCGGATGTTCAATGGTG -> CCTAAGCCGGATGTTCAATGGTGA
TACGTGTGTAGGGAACATGCAGCT -> ACGTGTGTAGGGAACATGCAGCTG
CGGAAATGGGCGGGTAGAATTGAG -> GGAAATGGGCGGGTAGAATTGAGA
GCGCAACAAAGACATTTAAAGACT -> CGCAACAAAGACATTTAAAGACTG
TGGATCCCGGGCTGCTTAAGACTC -> GGATCCCGGGCTGCTTAAGACTCA
CAGCATGTTCAATTCGATCTAGCG -> AGCATGTTCAATTCGATCTAGCGT
ACTGAGCAGCTGCGCCCGGCTACA -> CTGAGCAGCTGCGCCCGGCTACAG
CGATCTAGCGTCTAGAGCACAACT -> GATCTAGCGTCTAGAGCACAACTT
GCAATCGAGTTCGTACTGAACAGT -> CAATCGAGTTCGTACTGAACAGTT
CAGCGAGCGGAAATGGGCGGGTAG -> AGCGAGCGGAAATGGGCGGGTAGA
CTTCCTAGATGTCGGATCTTTCAG -> TTCCTAGATGTCGGATCTTTCAGA
CCAGTGCCTGCCTAGACATAGAGA -> CAGTGCCTGCCTAGACATAGAGAC
TAAGCCGGATGTTCAATGGTGAGC -> AAGCCGGATGTTCAATGGTGAGCG
ACCGGGACTCCGGCTTTGCTGATA -> CCGGGACTCCGGCTTTGCTGATAC
ATGTAACGTAGACGCACAGACATT -> TGTAACGTAGACGCACAGACATTA
AAACCGAATTCAATTAGGCGCAAC -> AACCGAATTCAATTAGGCGCAACA
TTGAAGATTTCTGCCCTAATTGAC -> TGAAGATTTCTGCCCTAATTGACT
ATCACAGCATGTTCAATTCGATCT -> TCACAGCATGTTCAATTCGATCTA
CCCTCAGAGACAGTGCCAATTCGA -> CCTCAGAGACAGTGCCAATTCGAT
CGGGTGGCCGTTATCCCACCAATC -> GGGTGGCCGTTATCCCACCAATCA
AGGGGGCTAGCGCATACCATACTT -> GGGGGCTAGCGCATACCATACTTC
TACGGTAGCTTCCCATACGCAATC -> ACGGTAGCTTCCCATACGCAATCG
GGTGTCCGCCAGACGCTAAACATG -> GTGTCCGCCAGACGCTAAACATGC
ACTGCGATGGAATTATAATAAGCG -> CTGCGATGGAATTATAATAAGCGA
ACCTGTTAGGGTTGGATCCGAACA -> CCTGTTAGGGTTGGATCCGAACAC
GTCAGTATCGCGGATGAGAACAAT -> TCAGTATCGCGGATGAGAACAATG
GCTTTACGCGCATTAGATCGTTGT -> CTTTACGCGCATTAGATCGTTGTG
AGAACAATGTGAAACTTGAAGATT -> GAACAATGTGAAACTTGAAGATTT
ACTATCCCTTGCACGTGCCCAATT -> CTATCCCTTGCACGTGCCCAATTA
GGTTGGATCCGAACACCACACGGA -> GTTGGATCCGAACACCACACGGAG
GCGAGCGCGAGTGCTATGTCGACA -> CGAGCGCGAGTGCTATGTCGACAA
AATAGTCCGTGAAGGGTCAGTATC -> ATAGTCCGTGAAGGGTCAGTATCG
GAAACTCGGATGAACCGCTGGAGG -> AAACTCGGATGAACCGCTGGAGGC
GGATGAACCGCTGGAGGCCGACGT -> GATGAACCGCTGGAGGCCGACGTT
TCGGGTTCGACTTTATTCAAGTGA -> CGGGTTCGACTTTATTCAAGTGAG
GGTCACTCGTCTCCTCTCGGGTTC -> GTCACTCGTCTCCTCTCGGGTTCG
ACTCAGTGCCACCCGCGGGAAACT -> CTCAGTGCCACCCGCGGGAAACTC
AAGGCTCTGTTAGGGCTCGAGGTT -> AGGCTCTGTTAGGGCTCGAGGTTG
TCGGTTTGCGGAGGCTGGAAAATT -> CGGTTTGCGGAGGCTGGAAAATTC
TGAACCGCTGGAGGCCGACGTTTC -> GAACCGCTGGAGGCCGACGTTTCG
AATCATATTGATCCTGGCTTTACG -> ATCATATTGATCCTGGCTTTACGC
CAATTCGATTCGATAACTAAGGTG -> AATTCGATTCGATAACTAAGGTGG
GTACAGAAAATCAAGCATAGAGAA -> TACAGAAAATCAAGCATAGAGAAG
TGCTGCATGCTCTGACAGCCCAAT -> GCTGCATGCTCTGACAGCCCAATC
TTCTGGATGTGAACGGTCTTTCCC -> TCTGGATGTGAACGGTCTTTCCCT
TTCACCGGGACTCCGGCTTTGCTG -> TCACCGGGACTCCGGCTTTGCTGA
GTTATCGTTTGCAGCCGTCGGAGA -> TTATCGTTTGCAGCCGTCGGAGAT
CCGGATGTTCAATGGTGAGCGTTA -> CGGATGTTCAATGGTGAGCGTTAT
TGCGATGGAATTATAATAAGCGAA -> GCGATGGAATTATAATAAGCGAAA
CACCTTGCGAGCGATTACCTAATA -> ACCTTGCGAGCGATTACCTAATAG
TTTCACCGGGACTCCGGCTTTGCT -> TTCACCGGGACTCCGGCTTTGCTG
ATGGAAAAAAAGTTGTGTTCTGGA -> TGGAAAAAAAGTTGTGTTCTGGAT
GGCCAAGGCTCTGTTAGGGCTCGA -> GCCAAGGCTCTGTTAGGGCTCGAG
GGATCCCGGGCTGCTTAAGACTCA -> GATCCCGGGCTGCTTAAGACTCAA
CGATGGAATTATAATAAGCGAAAT -> GATGGAATTATAATAAGCGAAATC
CCTGTGGCTACTCCAACGCACAGT -> CTGTGGCTACTCCAACGCACAGTT
TGCCACCCGCGGGAAACTCTAGTT -> GCCACCCGCGGGAAACTCTAGTTT
GTCCGTGAAGGGTCAGTATCGCGG -> TCCGTGAAGGGTCAGTATCGCGGA
CGGTAGCTTCCCATACGCAATCGA -> GGTAGCTTCCCATACGCAATCGAG
GTTGTGTTCTGGATGTGAACGGTC -> TTGTGTTCTGGATGTGAACGGTCT
TCATGCAGCCTACTGATGTAGAGG -> CATGCAGCCTACTGATGTAGAGGA
ATTAAAAACACCGCCCGTAAGATG -> TTAAAAACACCGCCCGTAAGATGG
GGTTCATGGTCTTTATTTTGTTGT -> GTTCATGGTCTTTATTTTGTTGTT
ATCGAAGATTGAGTTGCGGGGGTT -> TCGAAGATTGAGTTGCGGGGGTTT
ACGTAGACGCACAGACATTAGGGT -> CGTAGACGCACAGACATTAGGGTT
AGACCTGTTAGGGTTGGATCCGAA -> GACCTGTTAGGGTTGGATCCGAAC
TGAAACTTGAAGATTTCTGCCCTA -> GAAACTTGAAGATTTCTGCCCTAA
TCGGATCTTTCAGAAACTCAGTGC -> CGGATCTTTCAGAAACTCAGTGCC
CAGTATTGTGAAGACCCGGTCGTG -> AGTATTGTGAAGACCCGGTCGTGT
TGAAGATTTCTGCCCTAATTGACT -> GAAGATTTCTGCCCTAATTGACTA
AGAAACGTTAAATTACCTGGGGCC -> GAAACGTTAAATTACCTGGGGCCC
TTTTCACCGGGACTCCGGCTTTGC -> TTTCACCGGGACTCCGGCTTTGCT
GCGGGTAGAATTGAGAGCATGTCG -> CGGGTAGAATTGAGAGCATGTCGA
TCATCTTGATTATCTGCGGCGTCG -> CATCTTGATTATCTGCGGCGTCGG
TGTTAGACTCTAGATTACAAGTTC -> GTTAGACTCTAGATTACAAGTTCC
TGAGCAGCTGCGCCCGGCTACAGC -> GAGCAGCTGCGCCCGGCTACAGCG
CGGTCACTCGTCTCCTCTCGGGTT -> GGTCACTCGTCTCCTCTCGGGTTC
GATGTGAACGGTCTTTCCCTATTC -> ATGTGAACGGTCTTTCCCTATTCC
AATGAAGCGCGTGTATGTAACGTA -> ATGAAGCGCGTGTATGTAACGTAG
GGCCTGTGGCTACTCCAACGCACA -> GCCTGTGGCTACTCCAACGCACAG
CGCAACAAAGACATTTAAAGACTG -> GCAACAAAGACATTTAAAGACTGC
GGTTCGGGTGGCCGTTATCCCACC -> GTTCGGGTGGCCGTTATCCCACCA
AGCGAAATCGCGCCCTCCCGTAAC -> GCGAAATCGCGCCCTCCCGTAACA
TTCGCGTCACGCCGCATTGCATCA -> TCGCGTCACGCCGCATTGCATCAG
CTAATTGACTAGAAATTGGACTAC -> TAATTGACTAGAAATTGGACTACA
AAACGTTAAATTACCTGGGGCCCG -> AACGTTAAATTACCTGGGGCCCGG
GGGACTCCGGCTTTGCTGATACAT -> GGACTCCGGCTTTGCTGATACATG
ATGCAGCTGAAGCGTCGGGCCATT -> TGCAGCTGAAGCGTCGGGCCATTT
CCTAGATGTCGGATCTTTCAGAAA -> CTAGATGTCGGATCTTTCAGAAAC
GCTTCTAACGCTGGCTTAACTCCT -> CTTCTAACGCTGGCTTAACTCCTG
CACCGGGACTCCGGCTTTGCTGAT -> ACCGGGACTCCGGCTTTGCTGATA
AGTACAGTATTGTGAAGACCCGGT -> GTACAGTATTGTGAAGACCCGGTC
GGGAAATTGCGGCTGCGGCCAAGG -> GGAAATTGCGGCTGCGGCCAAGGC
TGTGAACGGTCTTTCCCTATTCCT -> GTGAACGGTCTTTCCCTATTCCTA
TACGCAATCGAGTTCGTACTGAAC -> ACGCAATCGAGTTCGTACTGAACA
TTGCAGCCGTCGGAGATGCCGGTC -> TGCAGCCGTCGGAGATGCCGGTCC
GATGAACCGCTGGAGGCCGACGTT -> ATGAACCGCTGGAGGCCGACGTTT
GGCCGTTATCCCACCAATCACAGC -> GCCGTTATCCCACCAATCACAGCA
CTTTCCCTATTCCTAAGCCGGATG -> TTTCCCTATTCCTAAGCCGGATGT
TGAAGCGTCGGGCCATTTGCTGCA -> GAAGCGTCGGGCCATTTGCTGCAT
GACTAGAAATTGGACTACACATAC -> ACTAGAAATTGGACTACACATACG
TGTATCACTCAGTAGGTTTAGCCT -> GTATCACTCAGTAGGTTTAGCCTA
GCGCCTGTAGGCAGCGTACAGAAA -> CGCCTGTAGGCAGCGTACAGAAAA
CGCATTAGATCGTTGTGAACTGAG -> GCATTAGATCGTTGTGAACTGAGC
ACACATACGTGTGTAGGGAACATG -> CACATACGTGTGTAGGGAACATGC
AACGTAGACGCACAGACATTAGGG -> ACGTAGACGCACAGACATTAGGGT
TTGTGTTCTGGATGTGAACGGTCT -> TGTGTTCTGGATGTGAACGGTCTT
GCGATTACCTAATAGTCCGTGAAG -> CGATTACCTAATAGTCCGTGAAGG
AGACATTTAAAGACTGCGATGGAA -> GACATTTAAAGACTGCGATGGAAT
CACTCGTCTCCTCTCGGGTTCGAC -> ACTCGTCTCCTCTCGGGTTCGACT
GAGACTCGAGGAGATAGCCTCGGT -> AGACTCGAGGAGATAGCCTCGGTT
CCCTAATTGACTAGAAATTGGACT -> CCTAATTGACTAGAAATTGGACTA
CCGACGTTTCGCTATGGAAAAAAA -> CGACGTTTCGCTATGGAAAAAAAG
ACTTCAGCCAATTGGAGCACACCA -> CTTCAGCCAATTGGAGCACACCAT
CCAATCTAGGCTCTAGGGGGCTAG -> CAATCTAGGCTCTAGGGGGCTAGC
GGCTTTACGCGCATTAGATCGTTG -> GCTTTACGCGCATTAGATCGTTGT
GAGCGGAAATGGGCGGGTAGAATT -> AGCGGAAATGGGCGGGTAGAATTG
ATCACTGAAGAGTTACAGATCCGG -> TCACTGAAGAGTTACAGATCCGGG
GTGTGGCCGGCAACTATCCCTTGC -> TGTGGCCGGCAACTATCCCTTGCA
AGCACACCATTTTCAATCATATTG -> GCACACCATTTTCAATCATATTGA
TAGGGTTCATGGTCTTTATTTTGT -> AGGGTTCATGGTCTTTATTTTGTT
AGCCCGACGGCCACTGTCACCCTC -> GCCCGACGGCCACTGTCACCCTCC
CGTCGAATGAAGCGCGTGTATGTA -> GTCGAATGAAGCGCGTGTATGTAA
TTCAAATATCACCGCTAAGTGGCC -> TCAAATATCACCGCTAAGTGGCCA
TGATCACTGAAGAGTTACAGATCC -> GATCACTGAAGAGTTACAGATCCG
TACCATCATGCAGCCTACTGATGT -> ACCATCATGCAGCCTACTGATGTA
TCGTGTATCACTCAGTAGGTTTAG -> CGTGTATCACTCAGTAGGTTTAGC
GTGCCCAATTAGATGATCACTGAA -> TGCCCAATTAGATGATCACTGAAG
AGCGTTATGTCAACGTCCCTTACA -> GCGTTATGTCAACGTCCCTTACAG
AGTATTGTGAAGACCCGGTCGTGT -> GTATTGTGAAGACCCGGTCGTGTG
TTGTTGCGGTCACTCGTCTCCTCT -> TGTTGCGGTCACTCGTCTCCTCTC
ATGAACCGCTGGAGGCCGACGTTT -> TGAACCGCTGGAGGCCGACGTTTC
ACAAGTTCCACGGGGGTGGATCCC -> CAAGTTCCACGGGGGTGGATCCCG
GAGGGCCTGTGGCTACTCCAACGC -> AGGGCCTGTGGCTACTCCAACGCA
CCTACTGATGTAGAGGAGACCCCA -> CTACTGATGTAGAGGAGACCCCAA
TAGAGACTGACGGACGATAGGCCT -> AGAGACTGACGGACGATAGGCCTG
CCGGTCGTGTGGCCGGCAACTATC -> CGGTCGTGTGGCCGGCAACTATCC
CTGGGTAACCTAACGGGGCCGGCT -> TGGGTAACCTAACGGGGCCGGCTA
TTACCTGGGGCCCGGGGGTAGCCT -> TACCTGGGGCCCGGGGGTAGCCTC
TAGCGTAGTACAGTATTGTGAAGA -> AGCGTAGTACAGTATTGTGAAGAC
GCGGTCACTCGTCTCCTCTCGGGT -> CGGTCACTCGTCTCCTCTCGGGTT
CAGTGCCTGCCTAGACATAGAGAC -> AGTGCCTGCCTAGACATAGAGACT
TGCGCCCGGCTACAGCGAGCGGAA -> GCGCCCGGCTACAGCGAGCGGAAA
TATTGATCCTGGCTTTACGCGCAT -> ATTGATCCTGGCTTTACGCGCATT
TTCTCCACCTTGCGAGCGATTACC -> TCTCCACCTTGCGAGCGATTACCT
GCTCGTACCGCCTTAGCGAGCGGT -> CTCGTACCGCCTTAGCGAGCGGTG
CGGGCAAGTCTTCCTAGATGTCGG -> GGGCAAGTCTTCCTAGATGTCGGA
TCTTTATTTTGTTGTTGCGGTCAC -> CTTTATTTTGTTGTTGCGGTCACT
GTTAAATTACCTGGGGCCCGGGGG -> TTAAATTACCTGGGGCCCGGGGGT
CTGACGGACGATAGGCCTGTGGCC -> TGACGGACGATAGGCCTGTGGCCT
TTTCCCTATTCCTAAGCCGGATGT -> TTCCCTATTCCTAAGCCGGATGTT
GACCTGACCTAAACCGAATTCAAT -> ACCTGACCTAAACCGAATTCAATT
CTGGGGCCCGGGGGTAGCCTCCGT -> TGGGGCCCGGGGGTAGCCTCCGTG
ATAAGTTGCGTCGTCGTGGGTGCT -> TAAGTTGCGTCGTCGTGGGTGCTC
TTCAATTCGATCTAGCGTCTAGAG -> TCAATTCGATCTAGCGTCTAGAGC
CTGAGTCGTCGTGTATCACTCAGT -> TGAGTCGTCGTGTATCACTCAGTA
TTAGGGTTCATGGTCTTTATTTTG -> TAGGGTTCATGGTCTTTATTTTGT
AAATGGGCGGGTAGAATTGAGAGC -> AATGGGCGGGTAGAATTGAGAGCA
CCGCCCGTAAGATGGGACGGTACC -> CGCCCGTAAGATGGGACGGTACCA
CTGTCACCCTCCCGTCCAGTGCCT -> TGTCACCCTCCCGTCCAGTGCCTG
AACTATCCCTTGCACGTGCCCAAT -> ACTATCCCTTGCACGTGCCCAATT
TCAATCATATTGATCCTGGCTTTA -> CAATCATATTGATCCTGGCTTTAC
GATTTCTGCCCTAATTGACTAGAA -> ATTTCTGCCCTAATTGACTAGAAA
AGACCCCAATGAAATGTATGTATA -> GACCCCAATGAAATGTATGTATAA
CGGGGGTAGCCTCCGTGCCTCCCG -> GGGGGTAGCCTCCGTGCCTCCCGG
GGGCCCGGGGGTAGCCTCCGTGCC -> GGCCCGGGGGTAGCCTCCGTGCCT
GAAACTCTAGTTTGCCCAAGCTCT -> AAACTCTAGTTTGCCCAAGCTCTT
CCCCAATGAAATGTATGTATAAGT -> CCCAATGAAATGTATGTATAAGTT
GAGAACAATGTGAAACTTGAAGAT -> AGAACAATGTGAAACTTGAAGATT
CAGCTGCGCCCGGCTACAGCGAGC -> AGCTGCGCCCGGCTACAGCGAGCG
TCGTACCGCCTTAGCGAGCGGTGG -> CGTACCGCCTTAGCGAGCGGTGGC
GCGCATTAGATCGTTGTGAACTGA -> CGCATTAGATCGTTGTGAACTGAG
GAGATAGCCTCGGTTTGCGGAGGC -> AGATAGCCTCGGTTTGCGGAGGCT
ACGGCCACTGTCACCCTCCCGTCC -> CGGCCACTGTCACCCTCCCGTCCA
TATCACCGCTAAGTGGCCAATCTG -> ATCACCGCTAAGTGGCCAATCTGA
AGCGAGCGCGAGTGCTATGTCGAC -> GCGAGCGCGAGTGCTATGTCGACA
GCGCATACCATACTTCAGCCAATT -> CGCATACCATACTTCAGCCAATTG
AGGGTTGGATCCGAACACCACACG -> GGGTTGGATCCGAACACCACACGG
TGTAGGGAACATGCAGCTGAAGCG -> GTAGGGAACATGCAGCTGAAGCGT
ACTAAGGTGGGAACATCAGACAGA -> CTAAGGTGGGAACATCAGACAGAA
TACTGATGTAGAGGAGACCCCAAT -> ACTGATGTAGAGGAGACCCCAATG
GCGAGCGATTACCTAATAGTCCGT -> CGAGCGATTACCTAATAGTCCGTG
TAGGCAATCGGACACGATCACGCG -> AGGCAATCGGACACGATCACGCGA
ACCCGCGGGAAACTCTAGTTTGCC -> CCCGCGGGAAACTCTAGTTTGCCC
AGCGATTACCTAATAGTCCGTGAA -> GCGATTACCTAATAGTCCGTGAAG
TTGCACGTGCCCAATTAGATGATC -> TGCACGTGCCCAATTAGATGATCA
ACCATTTTCAATCATATTGATCCT -> CCATTTTCAATCATATTGATCCTG
AGTTATCGTTTGCAGCCGTCGGAG -> GTTATCGTTTGCAGCCGTCGGAGA
CTCGGATGAACCGCTGGAGGCCGA -> TCGGATGAACCGCTGGAGGCCGAC
CCGCCAGACGCTAAACATGCCGAC -> CGCCAGACGCTAAACATGCCGACT
AGGGCTTCTAACGCTGGCTTAACT -> GGGCTTCTAACGCTGGCTTAACTC
CGTTTCGCTATGGAAAAAAAGTTG -> GTTTCGCTATGGAAAAAAAGTTGT
TCCACCTTGCGAGCGATTACCTAA -> CCACCTTGCGAGCGATTACCTAAT
TTCGGGTGGCCGTTATCCCACCAA -> TCGGGTGGCCGTTATCCCACCAAT
CCAATTGGAGCACACCATTTTCAA -> CAATTGGAGCACACCATTTTCAAT
AGAGCATGTCGAGAGATTAAAAAC -> GAGCATGTCGAGAGATTAAAAACA
AATGGGCGGGTAGAATTGAGAGCA -> ATGGGCGGGTAGAATTGAGAGCAT
TGGCGGATGTTAGACTCTAGATTA -> GGCGGATGTTAGACTCTAGATTAC
ATTCAAGTGAGGGCCTGTGGCTAC -> TTCAAGTGAGGGCCTGTGGCTACT
ATACCATACTTCAGCCAATTGGAG -> TACCATACTTCAGCCAATTGGAGC
TTTGTTTACCATGGTTCGGGTGGC -> TTGTTTACCATGGTTCGGGTGGCC
TCACAGCATGTTCAATTCGATCTA -> CACAGCATGTTCAATTCGATCTAG
AGGGAACATGCAGCTGAAGCGTCG -> GGGAACATGCAGCTGAAGCGTCGG
GGGGCCCGGGGGTAGCCTCCGTGC -> GGGCCCGGGGGTAGCCTCCGTGCC
GATGCCGGTCCCTCAGAGACAGTG -> ATGCCGGTCCCTCAGAGACAGTGC
TCAGCCAATTGGAGCACACCATTT -> CAGCCAATTGGAGCACACCATTTT
TTGATTATCTGCGGCGTCGGGGGA -> TGATTATCTGCGGCGTCGGGGGAG
AGTTTGCCCAAGCTCTTGGGGAAA -> GTTTGCCCAAGCTCTTGGGGAAAT
GTGTAGGGAACATGCAGCTGAAGC -> TGTAGGGAACATGCAGCTGAAGCG
GAGCACAACTTTTCACCGGGACTC -> AGCACAACTTTTCACCGGGACTCC
CGCACAGACATTAGGGTTCATGGT -> GCACAGACATTAGGGTTCATGGTC
TGCCTCCCGGGGCCCCTGAGACTC -> GCCTCCCGGGGCCCCTGAGACTCG
AGGCTCTGTTAGGGCTCGAGGTTG -> GGCTCTGTTAGGGCTCGAGGTTGA
CCTGCCTAGACATAGAGACTGACG -> CTGCCTAGACATAGAGACTGACGG
GAACATCAGACAGAAACTCGGATG -> AACATCAGACAGAAACTCGGATGA
CCCGGGGGTAGCCTCCGTGCCTCC -> CCGGGGGTAGCCTCCGTGCCTCCC
TTTGCGGAGGCTGGAAAATTCCGG -> TTGCGGAGGCTGGAAAATTCCGGC
CCTTAGCGAGCGGTGGCGGATGTT -> CTTAGCGAGCGGTGGCGGATGTTA
GCTCTTGGGGAAATTGCGGCTGCG -> CTCTTGGGGAAATTGCGGCTGCGG
ATAGCCTCGGTTTGCGGAGGCTGG -> TAGCCTCGGTTTGCGGAGGCTGGA
AACACATTCAAATATCACCGCTAA -> ACACATTCAAATATCACCGCTAAG
ACACATTCAAATATCACCGCTAAG -> CACATTCAAATATCACCGCTAAGT
TATGTCGACAAGGGCTTCTAACGC -> ATGTCGACAAGGGCTTCTAACGCT
AGATGGGACGGTACCAGCTAGGCA -> GATGGGACGGTACCAGCTAGGCAA
AAGCATAGAGAAGGGTGTGGTCGA -> AGCATAGAGAAGGGTGTGGTCGAA
CGCGTCACGCCGCATTGCATCAGA -> GCGTCACGCCGCATTGCATCAGAC
AAGCTCTTGGGGAAATTGCGGCTG -> AGCTCTTGGGGAAATTGCGGCTGC
CCCTTGCACGTGCCCAATTAGATG -> CCTTGCACGTGCCCAATTAGATGA
AAACTTGAAGATTTCTGCCCTAAT -> AACTTGAAGATTTCTGCCCTAATT
TCGTCTCCTCTCGGGTTCGACTTT -> CGTCTCCTCTCGGGTTCGACTTTA
CAACTTTTCACCGGGACTCCGGCT -> AACTTTTCACCGGGACTCCGGCTT
CGGGACTCCGGCTTTGCTGATACA -> GGGACTCCGGCTTTGCTGATACAT
GGTGGGAACATCAGACAGAAACTC -> GTGGGAACATCAGACAGAAACTCG
AAGTCTTCCTAGATGTCGGATCTT -> AGTCTTCCTAGATGTCGGATCTTT
CATACCATACTTCAGCCAATTGGA -> ATACCATACTTCAGCCAATTGGAG
TTACCTGTTATCGAAGATTGAGTT -> TACCTGTTATCGAAGATTGAGTTG
GCCGGATGTTCAATGGTGAGCGTT -> CCGGATGTTCAATGGTGAGCGTTA
GACGGTACCAGCTAGGCAATCGGA -> ACGGTACCAGCTAGGCAATCGGAC
CGAGTGCTATGTCGACAAGGGCTT -> GAGTGCTATGTCGACAAGGGCTTC
CTAATAGTCCGTGAAGGGTCAGTA -> TAATAGTCCGTGAAGGGTCAGTAT
AGGTTTAGCCTACCATCATGCAGC -> GGTTTAGCCTACCATCATGCAGCC
ACCTGTTATCGAAGATTGAGTTGC -> CCTGTTATCGAAGATTGAGTTGCG
ATAACTAAGGTGGGAACATCAGAC -> TAACTAAGGTGGGAACATCAGACA
GCCTCCGTGCCTCCCGGGGCCCCT -> CCTCCGTGCCTCCCGGGGCCCCTG
TTTATTCAAGTGAGGGCCTGTGGC -> TTATTCAAGTGAGGGCCTGTGGCT
ATAGAGAAGGGTGTGGTCGAACAA -> TAGAGAAGGGTGTGGTCGAACAAG
TTCTAACGCTGGCTTAACTCCTGT -> TCTAACGCTGGCTTAACTCCTGTG
TGCCTGCCTAGACATAGAGACTGA -> GCCTGCCTAGACATAGAGACTGAC
TCCGAACACCACACGGAGTTGACC -> CCGAACACCACACGGAGTTGACCC
GATAGGCCTGTGGCCTGGGTAACC -> ATAGGCCTGTGGCCTGGGTAACCT
AGATTACAAGTTCCACGGGGGTGG -> GATTACAAGTTCCACGGGGGTGGA
CGCGTGTATGTAACGTAGACGCAC -> GCGTGTATGTAACGTAGACGCACA
TCCGGCTTTGCTGATACATGCGGG -> CCGGCTTTGCTGATACATGCGGGC
GTCCCTTACAGTTCTCCACCTTGC -> TCCCTTACAGTTCTCCACCTTGCG
CTTACAGTTCTCCACCTTGCGAGC -> TTACAGTTCTCCACCTTGCGAGCG
CCGAATTCAATTAGGCGCAACAAA -> CGAATTCAATTAGGCGCAACAAAG
AAGATTTCTGCCCTAATTGACTAG -> AGATTTCTGCCCTAATTGACTAGA
GGTAGCTTCCCATACGCAATCGAG -> GTAGCTTCCCATACGCAATCGAGT
CGAACACCACACGGAGTTGACCCA -> GAACACCACACGGAGTTGACCCAA
GATTGAGTTGCGGGGGTTTTCACC -> ATTGAGTTGCGGGGGTTTTCACCA
ATGGAATTATAATAAGCGAAATCG -> TGGAATTATAATAAGCGAAATCGC
TCTAGGGGGCTAGCGCATACCATA -> CTAGGGGGCTAGCGCATACCATAC
AAGGGCTTCTAACGCTGGCTTAAC -> AGGGCTTCTAACGCTGGCTTAACT
AACGCTGGCTTAACTCCTGTGGTG -> ACGCTGGCTTAACTCCTGTGGTGT
GGCCTGGGTAACCTAACGGGGCCG -> GCCTGGGTAACCTAACGGGGCCGG
CTAAGTGGCCAATCTGAGTCGTCG -> TAAGTGGCCAATCTGAGTCGTCGT
CCTAAACCGAATTCAATTAGGCGC -> CTAAACCGAATTCAATTAGGCGCA
ACATAGAGACTGACGGACGATAGG -> CATAGAGACTGACGGACGATAGGC
CGGATGAGAACAATGTGAAACTTG -> GGATGAGAACAATGTGAAACTTGA
ATTATAATAAGCGAAATCGCGCCC -> TTATAATAAGCGAAATCGCGCCCT
TAACTCCTGTGGTGTCCGCCAGAC -> AACTCCTGTGGTGTCCGCCAGACG
GAGACTGACGGACGATAGGCCTGT -> AGACTGACGGACGATAGGCCTGTG
GCAGCTGAAGCGTCGGGCCATTTG -> CAGCTGAAGCGTCGGGCCATTTGC
ACTTTTCACCGGGACTCCGGCTTT -> CTTTTCACCGGGACTCCGGCTTTG
TCAGTATCGCGGATGAGAACAATG -> CAGTATCGCGGATGAGAACAATGT
CAAGCTCTTGGGGAAATTGCGGCT -> AAGCTCTTGGGGAAATTGCGGCTG
GGTGCTCGTACCGCCTTAGCGAGC -> GTGCTCGTACCGCCTTAGCGAGCG
TTAAAGACTGCGATGGAATTATAA -> TAAAGACTGCGATGGAATTATAAT
TGAGCGAGCGCGAGTGCTATGTCG -> GAGCGAGCGCGAGTGCTATGTCGA
CTCATCTTGATTATCTGCGGCGTC -> TCATCTTGATTATCTGCGGCGTCG
GCTGCGGCCAAGGCTCTGTTAGGG -> CTGCGGCCAAGGCTCTGTTAGGGC
GGGTGTGGTCGAACAAGATGGCCA -> GGTGTGGTCGAACAAGATGGCCAC
CACGTATACGGTAGCTTCCCATAC -> ACGTATACGGTAGCTTCCCATACG
AATTCGATTCGATAACTAAGGTGG -> ATTCGATTCGATAACTAAGGTGGG
TCAGACCTGACCTAAACCGAATTC -> CAGACCTGACCTAAACCGAATTCA
AACACCACACGGAGTTGACCCAAT -> ACACCACACGGAGTTGACCCAATG
GCGTGTATGTAACGTAGACGCACA -> CGTGTATGTAACGTAGACGCACAG
GAATTCAATTAGGCGCAACAAAGA -> AATTCAATTAGGCGCAACAAAGAC
GATGTTAGACTCTAGATTACAAGT -> ATGTTAGACTCTAGATTACAAGTT
GTGGCCGTTATCCCACCAATCACA -> TGGCCGTTATCCCACCAATCACAG
AACAATGTGAAACTTGAAGATTTC -> ACAATGTGAAACTTGAAGATTTCT
GAGGAGATAGCCTCGGTTTGCGGA -> AGGAGATAGCCTCGGTTTGCGGAG
GAAAATCAAGCATAGAGAAGGGTG -> AAAATCAAGCATAGAGAAGGGTGT
CTGCATGCTCTGACAGCCCAATCT -> TGCATGCTCTGACAGCCCAATCTA
TTACGCGCATTAGATCGTTGTGAA -> TACGCGCATTAGATCGTTGTGAAC
TTCACCAGACCTGTTAGGGTTGGA -> TCACCAGACCTGTTAGGGTTGGAT
GAGTTGCGGGGGTTTTCACCAGAC -> AGTTGCGGGGGTTTTCACCAGACC
GGCGCAACAAAGACATTTAAAGAC -> GCGCAACAAAGACATTTAAAGACT
GGTGTGGTCGAACAAGATGGCCAC -> GTGTGGTCGAACAAGATGGCCACG
GCGCGAGTGCTATGTCGACAAGGG -> CGCGAGTGCTATGTCGACAAGGGC
GGCCACGTATACGGTAGCTTCCCA -> GCCACGTATACGGTAGCTTCCCAT
GATCCTGGCTTTACGCGCATTAGA -> ATCCTGGCTTTACGCGCATTAGAT
AGCGTCTAGAGCACAACTTTTCAC -> GCGTCTAGAGCACAACTTTTCACC
GCATAGAGAAGGGTGTGGTCGAAC -> CATAGAGAAGGGTGTGGTCGAACA
GGGGTGGATCCCGGGCTGCTTAAG -> GGGTGGATCCCGGGCTGCTTAAGA
TGAGCGTTATGTCAACGTCCCTTA -> GAGCGTTATGTCAACGTCCCTTAC
TTAAAAACACCGCCCGTAAGATGG -> TAAAAACACCGCCCGTAAGATGGG
CGTACAGAAAATCAAGCATAGAGA -> GTACAGAAAATCAAGCATAGAGAA
GGGTAGCCGAAAGCCCGACGGCCA -> GGTAGCCGAAAGCCCGACGGCCAC
GGGCCCCTGAGACTCGAGGAGATA -> GGCCCCTGAGACTCGAGGAGATAG
AGATCCGGGCAAGTCTTCCTAGAT -> GATCCGGGCAAGTCTTCCTAGATG
CTGATGTAGAGGAGACCCCAATGA -> TGATGTAGAGGAGACCCCAATGAA
AATTGAGAGCATGTCGAGAGATTA -> ATTGAGAGCATGTCGAGAGATTAA
TTTACCATGGTTCGGGTGGCCGTT -> TTACCATGGTTCGGGTGGCCGTTA
CAGCTGAAGCGTCGGGCCATTTGC -> AGCTGAAGCGTCGGGCCATTTGCT
GAGACAGTGCCAATTCGATTCGAT -> AGACAGTGCCAATTCGATTCGATA
CTGAGACTCGAGGAGATAGCCTCG -> TGAGACTCGAGGAGATAGCCTCGG
TTGCGGGGGTTTTCACCAGACCTG -> TGCGGGGGTTTTCACCAGACCTGT
TGCAGCCTACTGATGTAGAGGAGA -> GCAGCCTACTGATGTAGAGGAGAC
CACACGGAGTTGACCCAATGAGAG -> ACACGGAGTTGACCCAATGAGAGC
ACTCAGTAGGTTTAGCCTACCATC -> CTCAGTAGGTTTAGCCTACCATCA
GTTCCACGGGGGTGGATCCCGGGC -> TTCCACGGGGGTGGATCCCGGGCT
GCGTTATGTCAACGTCCCTTACAG -> CGTTATGTCAACGTCCCTTACAGT
TGCTGATACATGCGGGCTTTATCA -> GCTGATACATGCGGGCTTTATCAG
GCAGCCGTCGGAGATGCCGGTCCC -> CAGCCGTCGGAGATGCCGGTCCCT
CCGTTATCCCACCAATCACAGCAT -> CGTTATCCCACCAATCACAGCATG
GAGATGCCGGTCCCTCAGAGACAG -> AGATGCCGGTCCCTCAGAGACAGT
ACACGGAGTTGACCCAATGAGAGC -> CACGGAGTTGACCCAATGAGAGCG
CTGAACAGTTATCGTTTGCAGCCG -> TGAACAGTTATCGTTTGCAGCCGT
CAGACATTAGGGTTCATGGTCTTT -> AGACATTAGGGTTCATGGTCTTTA
GTTGCGGTCACTCGTCTCCTCTCG -> TTGCGGTCACTCGTCTCCTCTCGG
TTCCGGCCATGTAGCGTAGTACAG -> TCCGGCCATGTAGCGTAGTACAGT