AAAACAGAAAA -> AAACAGAAAAT
AAAACGAAACA -> AAACGAAACAT
AAAATCAGCGA -> AAATCAGCGAC
AAAATTACAGA -> AAATTACAGAT
AAACAAAACGA -> AACAAAACGAA
AAACAGAAAAT -> AACAGAAAATT
AAACATATCCT -> AACATATCCTT
AAACCAAGATA -> AACCAAGATAA
AAACCTACCAG -> AACCTACCAGG
AAACGAAACAT -> AACGAAACATA
AAACGAGCGAG -> AACGAGCGAGT
AAACGAGTCAC -> AACGAGTCACC
AAACGTAACAG -> AACGTAACAGT
AAACTAGTCAC -> AACTAGTCACT
AAACTATTTTG -> AACTATTTTGC
AAAGGCTGTCA -> AAGGCTGTCAG
AAATACATCCG -> AATACATCCGC
AAATATGGGTT -> AATATGGGTTC
AAATCAGCGAC -> AATCAGCGACT
AAATGGGTGTG -> AATGGGTGTGC
AAATGTGCGAA -> AATGTGCGAAA
AAATTACAGAT -> AATTACAGATG
AACAAAACGAA -> ACAAAACGAAA
AACAAGGTGTT -> ACAAGGTGTTG
AACACCGACGA -> ACACCGACGAG
AACAGAAAATT -> ACAGAAAATTA
AACAGTATAAA -> ACAGTATAAAC
AACATACGGAC -> ACATACGGACG
AACATATCCTT -> ACATATCCTTA
AACCAAGATAA -> ACCAAGATAAT
AACCAATTAGA -> ACCAATTAGAC
AACCCTAGCAC -> ACCCTAGCACG
AACCGCCACGG -> ACCGCCACGGT
AACCTACCAGG -> ACCTACCAGGA
AACCTGTCGGG -> ACCTGTCGGGT
AACGAAACATA -> ACGAAACATAT
AACGAACAAGG -> ACGAACAAGGT
AACGAGCGAGT -> ACGAGCGAGTA
AACGAGTCACC -> ACGAGTCACCC
AACGCCGCGAT -> ACGCCGCGATA
AACGGGCCGGT -> ACGGGCCGGTT
AACGGTTAATT -> ACGGTTAATTG
AACGTAACAGT -> ACGTAACAGTA
AACTAGTCACT -> ACTAGTCACTT
AACTATTTTGC -> ACTATTTTGCG
AACTCCATTTC -> ACTCCATTTCT
AACTTAATGGC -> ACTTAATGGCC
AAGACAGGCCT -> AGACAGGCCTC
AAGACAGGGTT -> AGACAGGGTTG
AAGACGGCGCG -> AGACGGCGCGT
AAGACGTCAGC -> AGACGTCAGCT
AAGAGCAGGAT -> AGAGCAGGATA
AAGATAATGAA -> AGATAATGAAC
AAGCAGATTAT -> AGCAGATTATT
AAGCCAGTGTC -> AGCCAGTGTCC
AAGCCCGCTTA -> AGCCCGCTTAA
AAGCCCGGTGG -> AGCCCGGTGGT
AAGCCGGTAAG -> AGCCGGTAAGT
AAGCCTATAAT -> AGCCTATAATG
AAGCGTGCCGT -> AGCGTGCCGTA
AAGCTAGGATA -> AGCTAGGATAA
AAGGCTCCAAG -> AGGCTCCAAGG
AAGGCTGTCAG -> AGGCTGTCAGT
AAGGGCAATCC -> AGGGCAATCCA
AAGGTCTTTAC -> AGGTCTTTACC
AAGGTGAGGTG -> AGGTGAGGTGC
AAGGTGTTGGA -> AGGTGTTGGAT
AAGTAACACCG -> AGTAACACCGA
AAGTACTTACC -> AGTACTTACCT
AAGTAGGGTAG -> AGTAGGGTAGG
AAGTCAAATAT -> AGTCAAATATG
AAGTCCGGTAC -> AGTCCGGTACT
AAGTCGTTGCA -> AGTCGTTGCAA
AAGTGCTAGGC -> AGTGCTAGGCC
AATAAGCGTGC -> ATAAGCGTGCC
AATAAGTCGTT -> ATAAGTCGTTG
AATACATCCGC -> ATACATCCGCG
AATACTATAGT -> ATACTATAGTC
AATAGGTTTAC -> ATAGGTTTACC
AATATGGGTTC -> ATATGGGTTCC
AATCAGCCACG -> ATCAGCCACGT
AATCAGCGACT -> ATCAGCGACTC
AATCAGCGGCG -> ATCAGCGGCGG
AATCAGGCACG -> ATCAGGCACGG
AATCCAGACCG -> ATCCAGACCGA
AATCGAGCCAT -> ATCGAGCCATC
AATCTCAGTCC -> ATCTCAGTCCT
AATCTGAATAC -> ATCTGAATACT
AATGAACCAAT -> ATGAACCAATT
AATGACTCGGA -> ATGACTCGGAG
AATGCCACCAC -> ATGCCACCACG
AATGCCACTAC -> ATGCCACTACT
AATGGACCAGT -> ATGGACCAGTA
AATGGACTTGG -> ATGGACTTGGG
AATGGCCACAT -> ATGGCCACATG
AATGGGTGTGC -> ATGGGTGTGCG
AATGGTTAGAA -> ATGGTTAGAAC
AATGTGCGAAA -> ATGTGCGAAAG
AATGTGGTTGT -> ATGTGGTTGTT
AATTACAGATG -> ATTACAGATGT
AATTAGACAGG -> ATTAGACAGGT
AATTAGCACCC -> ATTAGCACCCT
AATTAGGTAAT -> ATTAGGTAATC
AATTGATCTAT -> ATTGATCTATC
AATTGATTTCG -> ATTGATTTCGT
AATTTGGAATG -> ATTTGGAATGG
ACAAAACGAAA -> CAAAACGAAAC
ACAAATACATC -> CAAATACATCC
ACAACATACGG -> CAACATACGGA
ACAAGGCTCCA -> CAAGGCTCCAA
ACAAGGTGTTG -> CAAGGTGTTGG
ACAATCAGCCA -> CAATCAGCCAC
ACAATTTGGAA -> CAATTTGGAAT
ACACAACATAC -> CACAACATACG
ACACCGACGAG -> CACCGACGAGA
ACACGACTTTG -> CACGACTTTGA
ACAGAAAATTA -> CAGAAAATTAC
ACAGAAGCCTA -> CAGAAGCCTAT
ACAGACAAGGC -> CAGACAAGGCT
ACAGATGTCTC -> CAGATGTCTCT
ACAGGCCTCGA -> CAGGCCTCGAC
ACAGGGTTGAG -> CAGGGTTGAGG
ACAGGTGCCTC -> CAGGTGCCTCA
ACAGTATAAAC -> CAGTATAAACT
ACAGTGCTCAG -> CAGTGCTCAGA
ACATACGGACG -> CATACGGACGA
ACATATATGCT -> CATATATGCTG
ACATATCCTTA -> CATATCCTTAA
ACATCAAAACA -> CATCAAAACAG
ACATCCCGCGC -> CATCCCGCGCA
ACATCCGCGCG -> CATCCGCGCGC
ACATGAAGTAA -> CATGAAGTAAC
ACATTAAACCA -> CATTAAACCAA
ACCAAGATAAT -> CCAAGATAATG
ACCAATAAGCG -> CCAATAAGCGT
ACCAATTAGAC -> CCAATTAGACA
ACCACGGGTCC -> CCACGGGTCCA
ACCAGGAGTTC -> CCAGGAGTTCA
ACCAGTAACCC -> CCAGTAACCCT
ACCCAGCCGAG -> CCCAGCCGAGT
ACCCGAGCACG -> CCCGAGCACGC
ACCCGTTCACC -> CCCGTTCACCG
ACCCTACGTTA -> CCCTACGTTAC
ACCCTAGCACG -> CCCTAGCACGA
ACCCTGGTGCG -> CCCTGGTGCGA
ACCGACGAGAC -> CCGACGAGACA
ACCGATTCCGC -> CCGATTCCGCA
ACCGATTGACG -> CCGATTGACGT
ACCGCCACGGT -> CCGCCACGGTG
ACCGCCCTTGT -> CCGCCCTTGTA
ACCGGACCGGC -> CCGGACCGGCA
ACCGGCAAGTC -> CCGGCAAGTCC
ACCGGCGACAT -> CCGGCGACATA
ACCGTGAGAAC -> CCGTGAGAACG
ACCTACCAGGA -> CCTACCAGGAG
ACCTATATCAT -> CCTATATCATG
ACCTCAGTCCA -> CCTCAGTCCAA
ACCTGTAGCGG -> CCTGTAGCGGG
ACCTGTCGGGT -> CCTGTCGGGTC
ACCTTTCTGCG -> CCTTTCTGCGA
ACGAAACATAT -> CGAAACATATC
ACGAACAAGGT -> CGAACAAGGTG
ACGACTTTGAA -> CGACTTTGAAG
ACGAGACAATC -> CGAGACAATCA
ACGAGACGATT -> CGAGACGATTT
ACGAGCGAGTA -> CGAGCGAGTAA
ACGAGTCACCC -> CGAGTCACCCT
ACGATATTGCC -> CGATATTGCCT
ACGATTTGCTT -> CGATTTGCTTT
ACGCCCTCTCG -> CGCCCTCTCGC
ACGCCGCGATA -> CGCCGCGATAT
ACGCCTTGCTA -> CGCCTTGCTAT
ACGGACGATAT -> CGGACGATATT
ACGGCACATCA -> CGGCACATCAA
ACGGCGCGTTA -> CGGCGCGTTAC
ACGGGCCGGTT -> CGGGCCGGTTG
ACGGGTCCATT -> CGGGTCCATTA
ACGGTGCCCTC -> CGGTGCCCTCT
ACGGTTAATTG -> CGGTTAATTGA
ACGTAACAGTA -> CGTAACAGTAT
ACGTCAGCTTT -> CGTCAGCTTTA
ACGTGCGCAGT -> CGTGCGCAGTG
ACGTGGGGACC -> CGTGGGGACCG
ACGTTACTATG -> CGTTACTATGT
ACTAAGGTGAG -> CTAAGGTGAGG
ACTACTCCAAG -> CTACTCCAAGT
ACTACTGTTCA -> CTACTGTTCAC
ACTAGATGATA -> CTAGATGATAA
ACTAGTCACTT -> CTAGTCACTTT
ACTATAGTCAG -> CTATAGTCAGG
ACTATGTGTGA -> CTATGTGTGAC
ACTATTTTGCG -> CTATTTTGCGC
ACTCCAAGTAG -> CTCCAAGTAGG
ACTCCATTTCT -> CTCCATTTCTG
ACTCCCAGAGG -> CTCCCAGAGGT
ACTCCCCGCCT -> CTCCCCGCCTA
ACTCGGAGTCT -> CTCGGAGTCTC
ACTGACCGTGA -> CTGACCGTGAG
ACTGTATGGAG -> CTGTATGGAGG
ACTGTTCACTT -> CTGTTCACTTT
ACTTAATGGCC -> CTTAATGGCCA
ACTTACCTTTC -> CTTACCTTTCT
ACTTCGCGGAG -> CTTCGCGGAGC
ACTTGGGGTGG -> CTTGGGGTGGG
ACTTGGTTCAG -> CTTGGTTCAGC
ACTTTACACAA -> CTTTACACAAC
ACTTTATTACA -> CTTTATTACAG
ACTTTGAAGCC -> CTTTGAAGCCA
ACTTTGAGTCA -> CTTTGAGTCAA
AGAAAATTACA -> GAAAATTACAG
AGAACGAACAA -> GAACGAACAAG
AGAACGCCGCG -> GAACGCCGCGA
AGAAGCCTATA -> GAAGCCTATAA
AGAATGCCACC -> GAATGCCACCA
AGACAAGGCTC -> GACAAGGCTCC
AGACAATCAGC -> GACAATCAGCC
AGACAGGCCTC -> GACAGGCCTCG
AGACAGGGTTG -> GACAGGGTTGA
AGACAGGTGCC -> GACAGGTGCCT
AGACCGATTGA -> GACCGATTGAC
AGACGATTTGC -> GACGATTTGCT
AGACGGCGCGT -> GACGGCGCGTT
AGACGTCAGCT -> GACGTCAGCTT
AGACTTTGAGT -> GACTTTGAGTC
AGAGAGTAGAA -> GAGAGTAGAAT
AGAGCAGGATA -> GAGCAGGATAC
AGAGGCATGTA -> GAGGCATGTAA
AGAGGTATATA -> GAGGTATATAG
AGAGTAAGCCG -> GAGTAAGCCGG
AGAGTAGAATG -> GAGTAGAATGC
AGAGTGGGCCT -> GAGTGGGCCTT
AGAGTTTTTTT -> GAGTTTTTTTC
AGATAATGAAC -> GATAATGAACC
AGATGATAAGC -> GATGATAAGCC
AGATGTCTCTC -> GATGTCTCTCC
AGATTATTCCT -> GATTATTCCTA
AGCAAAATCAG -> GCAAAATCAGC
AGCACCCTACG -> GCACCCTACGT
AGCACGAGACG -> GCACGAGACGA
AGCACGCCCTC -> GCACGCCCTCT
AGCAGATTATT -> GCAGATTATTC
AGCAGCGTTTA -> GCAGCGTTTAC
AGCAGGATACA -> GCAGGATACAG
AGCCACGTGCG -> GCCACGTGCGC
AGCCAGTGTCC -> GCCAGTGTCCG
AGCCATCGATC -> GCCATCGATCA
AGCCCGCTTAA -> GCCCGCTTAAC
AGCCCGGTGGT -> GCCCGGTGGTC
AGCCGAGTCCC -> GCCGAGTCCCA
AGCCGGTAAGT -> GCCGGTAAGTC
AGCCTATAATG -> GCCTATAATGA
AGCGACTCCCC -> GCGACTCCCCG
AGCGAGGTATA -> GCGAGGTATAT
AGCGAGTAATG -> GCGAGTAATGC
AGCGCTTTAGA -> GCGCTTTAGAG
AGCGGCGGTTG -> GCGGCGGTTGG
AGCGGGAACGG -> GCGGGAACGGG
AGCGTGCCGTA -> GCGTGCCGTAG
AGCGTTTACCT -> GCGTTTACCTG
AGCTACCGATT -> GCTACCGATTC
AGCTAGGATAA -> GCTAGGATAAT
AGCTTAACTTA -> GCTTAACTTAA
AGCTTCACAAT -> GCTTCACAATT
AGCTTTATCCG -> GCTTTATCCGA
AGGAATGGACT -> GGAATGGACTT
AGGACATCCCG -> GGACATCCCGC
AGGAGTTCAAT -> GGAGTTCAATT
AGGATAACTCC -> GGATAACTCCA
AGGATAATAAG -> GGATAATAAGT
AGGATAATCGA -> GGATAATCGAG
AGGATACAGAA -> GGATACAGAAG
AGGATTAGGAT -> GGATTAGGATA
AGGCACGGCAC -> GGCACGGCACA
AGGCATGTAAC -> GGCATGTAACC
AGGCCTAAGCA -> GGCCTAAGCAG
AGGCCTCGACA -> GGCCTCGACAA
AGGCGGTCACC -> GGCGGTCACCT
AGGCTCCAAGG -> GGCTCCAAGGG
AGGCTGTCAGT -> GGCTGTCAGTA
AGGGCAATCCA -> GGGCAATCCAG
AGGGGACCCAG -> GGGGACCCAGC
AGGGTAATCAG -> GGGTAATCAGG
AGGGTAGGACA -> GGGTAGGACAT
AGGGTTGAGGC -> GGGTTGAGGCG
AGGTAATCTCA -> GGTAATCTCAG
AGGTATATAGG -> GGTATATAGGA
AGGTATATCTC -> GGTATATCTCA
AGGTCTTTACC -> GGTCTTTACCG
AGGTGAGGTGC -> GGTGAGGTGCG
AGGTGCCTCAA -> GGTGCCTCAAG
AGGTGCGCATG -> GGTGCGCATGA
AGGTGTTGGAT -> GGTGTTGGATG
AGGTTTAATGG -> GGTTTAATGGT
AGTAACACCGA -> GTAACACCGAC
AGTAACCCTAG -> GTAACCCTAGC
AGTAAGCCGGT -> GTAAGCCGGTA
AGTAATGCCAC -> GTAATGCCACT
AGTACCCGAGC -> GTACCCGAGCA
AGTACTTACCT -> GTACTTACCTT
AGTAGAATGCC -> GTAGAATGCCA
AGTAGGGTAGG -> GTAGGGTAGGA
AGTATAAACTA -> GTATAAACTAG
AGTATTGTCAC -> GTATTGTCACT
AGTCAAACTAT -> GTCAAACTATT
AGTCAAATATG -> GTCAAATATGG
AGTCACAGACA -> GTCACAGACAA
AGTCACCCTGG -> GTCACCCTGGT
AGTCACTTTAC -> GTCACTTTACA
AGTCAGGGTAA -> GTCAGGGTAAT
AGTCCAAACAA -> GTCCAAACAAA
AGTCCCATGTA -> GTCCCATGTAC
AGTCCGGTACT -> GTCCGGTACTT
AGTCCTTGAAG -> GTCCTTGAAGT
AGTCGTTGCAA -> GTCGTTGCAAA
AGTCTCTTATC -> GTCTCTTATCC
AGTGACTTCGC -> GTGACTTCGCG
AGTGATTTTAG -> GTGATTTTAGC
AGTGCTAGGCC -> GTGCTAGGCCT
AGTGCTCAGAG -> GTGCTCAGAGA
AGTGGCACCAA -> GTGGCACCAAT
AGTGGGCCTTG -> GTGGGCCTTGC
AGTGTCCGCGC -> GTGTCCGCGCT
AGTTCAATTAG -> GTTCAATTAGC
AGTTCATGATC -> GTTCATGATCT
AGTTGCTCCTC -> GTTGCTCCTCA
AGTTTTTTTCC -> GTTTTTTTCCC
ATAAACGTAAC -> TAAACGTAACA
ATAAACTAGTC -> TAAACTAGTCA
ATAACTCCATT -> TAACTCCATTT
ATAAGACGGCG -> TAAGACGGCGC
ATAAGCCCGGT -> TAAGCCCGGTG
ATAAGCGTGCC -> TAAGCGTGCCG
ATAAGTACTTA -> TAAGTACTTAC
ATAAGTCGTTG -> TAAGTCGTTGC
ATAATAAGTCG -> TAATAAGTCGT
ATAATCGAGCC -> TAATCGAGCCA
ATAATGAACCA -> TAATGAACCAA
ATAATGACTCG -> TAATGACTCGG
ATACAGAAGCC -> TACAGAAGCCT
ATACATCCGCG -> TACATCCGCGC
ATACGGACGAT -> TACGGACGATA
ATACTATAGTC -> TACTATAGTCA
ATAGGAATGGA -> TAGGAATGGAC
ATAGTCACAGA -> TAGTCACAGAC
ATAGTCAGGGT -> TAGTCAGGGTA
ATAGTTCATGA -> TAGTTCATGAT
ATATAGGAATG -> TATAGGAATGG
ATATAGTCACA -> TATAGTCACAG
ATATATGCTGT -> TATATGCTGTG
ATATCATGATC -> TATCATGATCC
ATATCCTTAAA -> TATCCTTAAAC
ATATCTCATGT -> TATCTCATGTC
ATATGCTGTGA -> TATGCTGTGAT
ATATGGGTTCC -> TATGGGTTCCG
ATATTGCCTGC -> TATTGCCTGCA
ATCAAAACAGA -> TCAAAACAGAA
ATCAGCCACGT -> TCAGCCACGTG
ATCAGCGACTC -> TCAGCGACTCC
ATCAGCGGCGG -> TCAGCGGCGGT
ATCAGGCACGG -> TCAGGCACGGC
ATCATCCCTGT -> TCATCCCTGTG
ATCATGATCCT -> TCATGATCCTC
ATCCAGACCGA -> TCCAGACCGAT
ATCCCGCGCAT -> TCCCGCGCATT
ATCCCTGTGGC -> TCCCTGTGGCC
ATCCGAAGCTA -> TCCGAAGCTAG
ATCCGCGCGCA -> TCCGCGCGCAG
ATCCTATGTGA -> TCCTATGTGAA
ATCCTCAAGCC -> TCCTCAAGCCC
ATCCTTAAACC -> TCCTTAAACCT
ATCCTTATTTT -> TCCTTATTTTG
ATCGAATTGAT -> TCGAATTGATT
ATCGAGCCATC -> TCGAGCCATCG
ATCGATCATCC -> TCGATCATCCC
ATCTATCTTCA -> TCTATCTTCAG
ATCTCAGTCCT -> TCTCAGTCCTT
ATCTCATGTCA -> TCTCATGTCAG
ATCTGAATACT -> TCTGAATACTA
ATCTTCAGCAA -> TCTTCAGCAAA
ATCTTTAATAG -> TCTTTAATAGG
ATGAACCAATT -> TGAACCAATTA
ATGAAGTAACA -> TGAAGTAACAC
ATGACTCGGAG -> TGACTCGGAGT
ATGAGTGACTT -> TGAGTGACTTC
ATGAGTGATTT -> TGAGTGATTTT
ATGATAAGACG -> TGATAAGACGG
ATGATAAGCCC -> TGATAAGCCCG
ATGATCCTCAA -> TGATCCTCAAG
ATGATCTTTAA -> TGATCTTTAAT
ATGCCACCACG -> TGCCACCACGG
ATGCCACTACT -> TGCCACTACTG
ATGCGGCGCTA -> TGCGGCGCTAA
ATGCTGTGATA -> TGCTGTGATAA
ATGGACCAGTA -> TGGACCAGTAA
ATGGACTTGGG -> TGGACTTGGGG
ATGGAGGGGAC -> TGGAGGGGACC
ATGGCCACATG -> TGGCCACATGA
ATGGGTGTGCG -> TGGGTGTGCGG
ATGGGTTCCGA -> TGGGTTCCGAG
ATGGTTAGAAC -> TGGTTAGAACG
ATGTAACCTGT -> TGTAACCTGTC
ATGTACTAGAT -> TGTACTAGATG
ATGTCAGACTT -> TGTCAGACTTT
ATGTCTCCAGG -> TGTCTCCAGGA
ATGTCTCTCCC -> TGTCTCTCCCC
ATGTGAACCGC -> TGTGAACCGCC
ATGTGCGAAAG -> TGTGCGAAAGG
ATGTGGTTGTT -> TGTGGTTGTTT
ATGTGTGACAC -> TGTGTGACACG
ATTAAACCAAG -> TTAAACCAAGA
ATTACAGATGT -> TTACAGATGTC
ATTACAGTGCT -> TTACAGTGCTC
ATTAGACAGGT -> TTAGACAGGTG
ATTAGCACCCT -> TTAGCACCCTA
ATTAGCGAGGT -> TTAGCGAGGTA
ATTAGGATAAC -> TTAGGATAACT
ATTAGGTAATC -> TTAGGTAATCT
ATTATTCCTAC -> TTATTCCTACA
ATTCCGCACTG -> TTCCGCACTGT
ATTCCTACATT -> TTCCTACATTA
ATTGACGTGGG -> TTGACGTGGGG
ATTGATCTATC -> TTGATCTATCT
ATTGATTTCGT -> TTGATTTCGTG
ATTGCCTGCAA -> TTGCCTGCAAT
ATTGGAGTACC -> TTGGAGTACCC
ATTGTCACTAA -> TTGTCACTAAG
ATTTCGTGTTC -> TTTCGTGTTCA
ATTTCTGAATC -> TTTCTGAATCA
ATTTGCTTTCG -> TTTGCTTTCGT
ATTTGGAATGG -> TTTGGAATGGA
ATTTTAGCGCT -> TTTTAGCGCTT
ATTTTGCGCTC -> TTTTGCGCTCT
ATTTTGTTGCC -> TTTTGTTGCCG
CAAAACAGAAA -> AAAACAGAAAA
CAAAACGAAAC -> AAAACGAAACA
CAAAATCAGCG -> AAAATCAGCGA
CAAACAAAACG -> AAACAAAACGA
CAAACGAGCGA -> AAACGAGCGAG
CAAACGAGTCA -> AAACGAGTCAC
CAAACTATTTT -> AAACTATTTTG
CAAATACATCC -> AAATACATCCG
CAAATATGGGT -> AAATATGGGTT
CAACATACGGA -> AACATACGGAC
CAAGACGTCAG -> AAGACGTCAGC
CAAGAGCAGGA -> AAGAGCAGGAT
CAAGATAATGA -> AAGATAATGAA
CAAGCCCGCTT -> AAGCCCGCTTA
CAAGGCTCCAA -> AAGGCTCCAAG
CAAGGGCAATC -> AAGGGCAATCC
CAAGGTGTTGG -> AAGGTGTTGGA
CAAGTAGGGTA -> AAGTAGGGTAG
CAAGTCCGGTA -> AAGTCCGGTAC
CAATAAGCGTG -> AATAAGCGTGC
CAATCAGCCAC -> AATCAGCCACG
CAATCCAGACC -> AATCCAGACCG
CAATCTGAATA -> AATCTGAATAC
CAATGTGGTTG -> AATGTGGTTGT
CAATTAGACAG -> AATTAGACAGG
CAATTAGCACC -> AATTAGCACCC
CAATTAGGTAA -> AATTAGGTAAT
CAATTTGGAAT -> AATTTGGAATG
CACAACATACG -> ACAACATACGG
CACAATTTGGA -> ACAATTTGGAA
CACAGACAAGG -> ACAGACAAGGC
CACATCAAAAC -> ACATCAAAACA
CACATGAAGTA -> ACATGAAGTAA
CACCAATAAGC -> ACCAATAAGCG
CACCACGGGTC -> ACCACGGGTCC
CACCCTACGTT -> ACCCTACGTTA
CACCCTGGTGC -> ACCCTGGTGCG
CACCGACGAGA -> ACCGACGAGAC
CACCGGACCGG -> ACCGGACCGGC
CACCTATATCA -> ACCTATATCAT
CACGACTTTGA -> ACGACTTTGAA
CACGAGACGAT -> ACGAGACGATT
CACGCCCTCTC -> ACGCCCTCTCG
CACGCCTTGCT -> ACGCCTTGCTA
CACGGCACATC -> ACGGCACATCA
CACGGGTCCAT -> ACGGGTCCATT
CACGGTGCCCT -> ACGGTGCCCTC
CACGTGCGCAG -> ACGTGCGCAGT
CACTAAGGTGA -> ACTAAGGTGAG
CACTACTCCAA -> ACTACTCCAAG
CACTACTGTTC -> ACTACTGTTCA
CACTGACCGTG -> ACTGACCGTGA
CACTGTATGGA -> ACTGTATGGAG
CACTTTACACA -> ACTTTACACAA
CACTTTATTAC -> ACTTTATTACA
CAGAAAATTAC -> AGAAAATTACA
CAGAAGCCTAT -> AGAAGCCTATA
CAGACAAGGCT -> AGACAAGGCTC
CAGACCGATTG -> AGACCGATTGA
CAGACTTTGAG -> AGACTTTGAGT
CAGAGAGTAGA -> AGAGAGTAGAA
CAGAGGCATGT -> AGAGGCATGTA
CAGAGGTATAT -> AGAGGTATATA
CAGAGTGGGCC -> AGAGTGGGCCT
CAGATGTCTCT -> AGATGTCTCTC
CAGATTATTCC -> AGATTATTCCT
CAGCAAAATCA -> AGCAAAATCAG
CAGCCACGTGC -> AGCCACGTGCG
CAGCCGAGTCC -> AGCCGAGTCCC
CAGCGACTCCC -> AGCGACTCCCC
CAGCGGCGGTT -> AGCGGCGGTTG
CAGCGTTTACC -> AGCGTTTACCT
CAGCTTAACTT -> AGCTTAACTTA
CAGCTTTATCC -> AGCTTTATCCG
CAGGAGTTCAA -> AGGAGTTCAAT
CAGGATAATCG -> AGGATAATCGA
CAGGATACAGA -> AGGATACAGAA
CAGGCACGGCA -> AGGCACGGCAC
CAGGCCTCGAC -> AGGCCTCGACA
CAGGGTAATCA -> AGGGTAATCAG
CAGGGTTGAGG -> AGGGTTGAGGC
CAGGTGCCTCA -> AGGTGCCTCAA
CAGTAACCCTA -> AGTAACCCTAG
CAGTATAAACT -> AGTATAAACTA
CAGTATTGTCA -> AGTATTGTCAC
CAGTCCAAACA -> AGTCCAAACAA
CAGTCCTTGAA -> AGTCCTTGAAG
CAGTGCTCAGA -> AGTGCTCAGAG
CAGTGGCACCA -> AGTGGCACCAA
CAGTGTCCGCG -> AGTGTCCGCGC
CATACGGACGA -> ATACGGACGAT
CATATATGCTG -> ATATATGCTGT
CATATCCTTAA -> ATATCCTTAAA
CATCAAAACAG -> ATCAAAACAGA
CATCCCGCGCA -> ATCCCGCGCAT
CATCCCTGTGG -> ATCCCTGTGGC
CATCCGCGCGC -> ATCCGCGCGCA
CATCGAATTGA -> ATCGAATTGAT
CATCGATCATC -> ATCGATCATCC
CATGAAGTAAC -> ATGAAGTAACA
CATGAGTGATT -> ATGAGTGATTT
CATGATCCTCA -> ATGATCCTCAA
CATGATCTTTA -> ATGATCTTTAA
CATGTAACCTG -> ATGTAACCTGT
CATGTACTAGA -> ATGTACTAGAT
CATGTCAGACT -> ATGTCAGACTT
CATTAAACCAA -> ATTAAACCAAG
CATTAGCGAGG -> ATTAGCGAGGT
CATTGGAGTAC -> ATTGGAGTACC
CATTTCTGAAT -> ATTTCTGAATC
CCAAACAAAAC -> CAAACAAAACG
CCAAGATAATG -> CAAGATAATGA
CCAAGGGCAAT -> CAAGGGCAATC
CCAAGTAGGGT -> CAAGTAGGGTA
CCAATAAGCGT -> CAATAAGCGTG
CCAATTAGACA -> CAATTAGACAG
CCACATGAAGT -> CACATGAAGTA
CCACCACGGGT -> CACCACGGGTC
CCACGGGTCCA -> CACGGGTCCAT
CCACGGTGCCC -> CACGGTGCCCT
CCACGTGCGCA -> CACGTGCGCAG
CCACTACTGTT -> CACTACTGTTC
CCAGACCGATT -> CAGACCGATTG
CCAGAGGTATA -> CAGAGGTATAT
CCAGAGTGGGC -> CAGAGTGGGCC
CCAGCCGAGTC -> CAGCCGAGTCC
CCAGGAGTTCA -> CAGGAGTTCAA
CCAGGATAATC -> CAGGATAATCG
CCAGTAACCCT -> CAGTAACCCTA
CCAGTGTCCGC -> CAGTGTCCGCG
CCATCGATCAT -> CATCGATCATC
CCATGTACTAG -> CATGTACTAGA
CCATTAGCGAG -> CATTAGCGAGG
CCATTTCTGAA -> CATTTCTGAAT
CCCAGAGGTAT -> CCAGAGGTATA
CCCAGCCGAGT -> CCAGCCGAGTC
CCCATGTACTA -> CCATGTACTAG
CCCCCGCTACC -> CCCCGCTACCT
CCCCGCCTATC -> CCCGCCTATCC
CCCCGCTACCT -> CCCGCTACCTC
CCCCGTTGTTA -> CCCGTTGTTAT
CCCGAGCACGC -> CCGAGCACGCC
CCCGCAATCTG -> CCGCAATCTGA
CCCGCCTATCC -> CCGCCTATCCT
CCCGCGCATTG -> CCGCGCATTGG
CCCGCTACCTC -> CCGCTACCTCA
CCCGCTTAACG -> CCGCTTAACGG
CCCGGTGGTCT -> CCGGTGGTCTC
CCCGTTCACCG -> CCGTTCACCGG
CCCGTTGTTAT -> CCGTTGTTATG
CCCTACGTTAC -> CCTACGTTACT
CCCTAGCACGA -> CCTAGCACGAG
CCCTCTCGCCC -> CCTCTCGCCCC
CCCTCTCTGTA -> CCTCTCTGTAT
CCCTGGTGCGA -> CCTGGTGCGAA
CCCTGTGGCCG -> CCTGTGGCCGG
CCCTTGTAGTT -> CCTTGTAGTTG
CCGAAGCTAGG -> CGAAGCTAGGA
CCGACGAGACA -> CGACGAGACAA
CCGAGCACGCC -> CGAGCACGCCC
CCGAGCTACCG -> CGAGCTACCGA
CCGAGTCCCAT -> CGAGTCCCATG
CCGATTCCGCA -> CGATTCCGCAC
CCGATTGACGT -> CGATTGACGTG
CCGCAATCTGA -> CGCAATCTGAA
CCGCACTGTAT -> CGCACTGTATG
CCGCCACGGTG -> CGCCACGGTGC
CCGCCCTTGTA -> CGCCCTTGTAG
CCGCCTATCCT -> CGCCTATCCTT
CCGCGATATAG -> CGCGATATAGT
CCGCGCATTGG -> CGCGCATTGGA
CCGCGCGCAGA -> CGCGCGCAGAG
CCGCGCTGTTG -> CGCGCTGTTGG
CCGCTACCTCA -> CGCTACCTCAG
CCGCTTAACGG -> CGCTTAACGGT
CCGGACCGGCA -> CGGACCGGCAA
CCGGCAAGTCC -> CGGCAAGTCCG
CCGGCGACATA -> CGGCGACATAT
CCGGTAAATGG -> CGGTAAATGGG
CCGGTAAGTCA -> CGGTAAGTCAA
CCGGTACTTGG -> CGGTACTTGGT
CCGGTGGTCTC -> CGGTGGTCTCG
CCGGTTGGTCA -> CGGTTGGTCAC
CCGTAGGATTA -> CGTAGGATTAG
CCGTGAGAACG -> CGTGAGAACGA
CCGTTCACCGG -> CGTTCACCGGA
CCGTTGTTATG -> CGTTGTTATGT
CCGTTTTGATG -> CGTTTTGATGA
CCTAAGCAGAT -> CTAAGCAGATT
CCTACATTAAA -> CTACATTAAAC
CCTACCAGGAG -> CTACCAGGAGT
CCTACGTTACT -> CTACGTTACTA
CCTAGCACGAG -> CTAGCACGAGA
CCTATAATGAC -> CTATAATGACT
CCTATATCATG -> CTATATCATGA
CCTATCCTTAT -> CTATCCTTATT
CCTATGTGAAC -> CTATGTGAACC
CCTCAAGACGT -> CTCAAGACGTC
CCTCAAGCCCG -> CTCAAGCCCGC
CCTCACTGACC -> CTCACTGACCG
CCTCAGTCCAA -> CTCAGTCCAAA
CCTCGACAAAT -> CTCGACAAATA
CCTCTCGCCCC -> CTCTCGCCCCC
CCTCTCTGTAT -> CTCTCTGTATA
CCTGCAATTAG -> CTGCAATTAGG
CCTGGTGCGAA -> CTGGTGCGAAG
CCTGTAGCGGG -> CTGTAGCGGGA
CCTGTCGGGTC -> CTGTCGGGTCG
CCTGTGGCCGG -> CTGTGGCCGGT
CCTTAAACCTA -> CTTAAACCTAC
CCTTATTTTGT -> CTTATTTTGTT
CCTTGAAGTGC -> CTTGAAGTGCT
CCTTGCGCACG -> CTTGCGCACGC
CCTTGCTATAA -> CTTGCTATAAA
CCTTGTAGTTG -> CTTGTAGTTGC
CCTTTCTGCGA -> CTTTCTGCGAC
CGAAACATATC -> GAAACATATCC
CGAAAGGCTGT -> GAAAGGCTGTC
CGAAATGTGCG -> GAAATGTGCGA
CGAACAAGGTG -> GAACAAGGTGT
CGAAGCTAGGA -> GAAGCTAGGAT
CGAAGGTCTTT -> GAAGGTCTTTA
CGAATTGATTT -> GAATTGATTTC
CGACAAATACA -> GACAAATACAT
CGACATATATG -> GACATATATGC
CGACGAGACAA -> GACGAGACAAT
CGACTCCCAGA -> GACTCCCAGAG
CGACTCCCCGC -> GACTCCCCGCC
CGACTTTGAAG -> GACTTTGAAGC
CGAGACAATCA -> GAGACAATCAG
CGAGACGATTT -> GAGACGATTTG
CGAGCACGCCC -> GAGCACGCCCT
CGAGCCATCGA -> GAGCCATCGAT
CGAGCGAGTAA -> GAGCGAGTAAT
CGAGCTACCGA -> GAGCTACCGAT
CGAGGTATATC -> GAGGTATATCT
CGAGTAATGCC -> GAGTAATGCCA
CGAGTCACCCT -> GAGTCACCCTG
CGAGTCCCATG -> GAGTCCCATGT
CGATATAGTCA -> GATATAGTCAC
CGATATTGCCT -> GATATTGCCTG
CGATCATCCCT -> GATCATCCCTG
CGATTCCGCAC -> GATTCCGCACT
CGATTGACGTG -> GATTGACGTGG
CGATTTGCTTT -> GATTTGCTTTC
CGCAATCTGAA -> GCAATCTGAAT
CGCACGCCTTG -> GCACGCCTTGC
CGCACTGTATG -> GCACTGTATGG
CGCAGAGGCAT -> GCAGAGGCATG
CGCAGTGGCAC -> GCAGTGGCACC
CGCATGAGTGA -> GCATGAGTGAT
CGCATTGGAGT -> GCATTGGAGTA
CGCCACGGTGC -> GCCACGGTGCC
CGCCCCCGCTA -> GCCCCCGCTAC
CGCCCTCTCGC -> GCCCTCTCGCC
CGCCCTTGTAG -> GCCCTTGTAGT
CGCCGCGATAT -> GCCGCGATATA
CGCCTATCCTT -> GCCTATCCTTA
CGCCTTGCTAT -> GCCTTGCTATA
CGCGATATAGT -> GCGATATAGTC
CGCGCAGAGGC -> GCGCAGAGGCA
CGCGCATTGGA -> GCGCATTGGAG
CGCGCGCAGAG -> GCGCGCAGAGG
CGCGCTGTTGG -> GCGCTGTTGGC
CGCGGAGCTTC -> GCGGAGCTTCA
CGCGTTACCCG -> GCGTTACCCGT
CGCTAAGACAG -> GCTAAGACAGG
CGCTACCTCAG -> GCTACCTCAGT
CGCTCTGGTCA -> GCTCTGGTCAA
CGCTGTTGGCC -> GCTGTTGGCCA
CGCTTAACGGT -> GCTTAACGGTT
CGCTTTAGAGT -> GCTTTAGAGTT
CGGACCGGCAA -> GGACCGGCAAG
CGGACGATATT -> GGACGATATTG
CGGAGCTTCAC -> GGAGCTTCACA
CGGAGGTTTAA -> GGAGGTTTAAT
CGGAGTCTCTT -> GGAGTCTCTTA
CGGCAAACGAG -> GGCAAACGAGC
CGGCAAGTCCG -> GGCAAGTCCGG
CGGCACATCAA -> GGCACATCAAA
CGGCGACATAT -> GGCGACATATA
CGGCGCGTTAC -> GGCGCGTTACC
CGGCGCTAAGA -> GGCGCTAAGAC
CGGCGGTTGGT -> GGCGGTTGGTT
CGGGAACGGGC -> GGGAACGGGCC
CGGGCCGGTTG -> GGGCCGGTTGG
CGGGGCATCGA -> GGGGCATCGAA
CGGGTCCATTA -> GGGTCCATTAG
CGGGTCGGAGG -> GGGTCGGAGGT
CGGTAAATGGG -> GGTAAATGGGT
CGGTAAGTCAA -> GGTAAGTCAAA
CGGTACTTGGT -> GGTACTTGGTT
CGGTCACCTAT -> GGTCACCTATA
CGGTGCCCTCT -> GGTGCCCTCTC
CGGTGGTCTCG -> GGTGGTCTCGA
CGGTTAATTGA -> GGTTAATTGAT
CGGTTGGTCAC -> GGTTGGTCACT
CGGTTGGTTGC -> GGTTGGTTGCT
CGTAACAGTAT -> GTAACAGTATA
CGTAGGATTAG -> GTAGGATTAGG
CGTCAGCTTTA -> GTCAGCTTTAT
CGTGAGAACGA -> GTGAGAACGAA
CGTGCCGTAGG -> GTGCCGTAGGA
CGTGCGCAGTG -> GTGCGCAGTGG
CGTGGGGACCG -> GTGGGGACCGC
CGTGTTCAATG -> GTGTTCAATGT
CGTTACCCGTT -> GTTACCCGTTC
CGTTACTATGT -> GTTACTATGTG
CGTTCACCGGA -> GTTCACCGGAC
CGTTCTAGCAG -> GTTCTAGCAGC
CGTTGCAAACG -> GTTGCAAACGA
CGTTGTTATGT -> GTTGTTATGTC
CGTTTACCTGT -> GTTTACCTGTA
CGTTTTGATGA -> GTTTTGATGAT
CTAAGACAGGC -> TAAGACAGGCC
CTAAGACAGGG -> TAAGACAGGGT
CTAAGCAGATT -> TAAGCAGATTA
CTAAGGTGAGG -> TAAGGTGAGGT
CTACATTAAAC -> TACATTAAACC
CTACCAGGAGT -> TACCAGGAGTT
CTACCGATTCC -> TACCGATTCCG
CTACCTCAGTC -> TACCTCAGTCC
CTACGTTACTA -> TACGTTACTAT
CTACTCCAAGT -> TACTCCAAGTA
CTACTGTTCAC -> TACTGTTCACT
CTAGATGATAA -> TAGATGATAAG
CTAGCACGAGA -> TAGCACGAGAC
CTAGCAGCGTT -> TAGCAGCGTTT
CTAGGATAATA -> TAGGATAATAA
CTAGGCCTAAG -> TAGGCCTAAGC
CTAGTCACTTT -> TAGTCACTTTA
CTATAAACGTA -> TATAAACGTAA
CTATAATGACT -> TATAATGACTC
CTATAGTCAGG -> TATAGTCAGGG
CTATATCATGA -> TATATCATGAT
CTATCCTTATT -> TATCCTTATTT
CTATCTTCAGC -> TATCTTCAGCA
CTATGTGAACC -> TATGTGAACCG
CTATGTGTGAC -> TATGTGTGACA
CTATTTTGCGC -> TATTTTGCGCT
CTCAAGACGTC -> TCAAGACGTCA
CTCAAGCCCGC -> TCAAGCCCGCT
CTCACTGACCG -> TCACTGACCGT
CTCAGAGAGTA -> TCAGAGAGTAG
CTCAGTCCAAA -> TCAGTCCAAAC
CTCAGTCCTTG -> TCAGTCCTTGA
CTCATGTCAGA -> TCATGTCAGAC
CTCCAAGGGCA -> TCCAAGGGCAA
CTCCAAGTAGG -> TCCAAGTAGGG
CTCCAGGATAA -> TCCAGGATAAT
CTCCATTTCTG -> TCCATTTCTGA
CTCCCAGAGGT -> TCCCAGAGGTA
CTCCCCGCCTA -> TCCCCGCCTAT
CTCCCCGTTGT -> TCCCCGTTGTT
CTCCTCACTGA -> TCCTCACTGAC
CTCGAAATGTG -> TCGAAATGTGC
CTCGACAAATA -> TCGACAAATAC
CTCGCCCCCGC -> TCGCCCCCGCT
CTCGGAGTCTC -> TCGGAGTCTCT
CTCGGCAAACG -> TCGGCAAACGA
CTCTCCCCGTT -> TCTCCCCGTTG
CTCTCGCCCCC -> TCTCGCCCCCG
CTCTCTGTATA -> TCTCTGTATAG
CTCTGGTCAAG -> TCTGGTCAAGA
CTCTGTATAGT -> TCTGTATAGTT
CTCTTATCCTA -> TCTTATCCTAT
CTGAATACTAT -> TGAATACTATA
CTGAATCAGCG -> TGAATCAGCGG
CTGACCGTGAG -> TGACCGTGAGA
CTGCAATTAGG -> TGCAATTAGGT
CTGCGACTCCC -> TGCGACTCCCA
CTGGAGAGTAA -> TGGAGAGTAAG
CTGGTCAAGAG -> TGGTCAAGAGC
CTGGTGCGAAG -> TGGTGCGAAGG
CTGTAGCGGGA -> TGTAGCGGGAA
CTGTATAGTTC -> TGTATAGTTCA
CTGTATGGAGG -> TGTATGGAGGG
CTGTCAGTATT -> TGTCAGTATTG
CTGTCGGGTCG -> TGTCGGGTCGG
CTGTGATAAGT -> TGTGATAAGTA
CTGTGGCCGGT -> TGTGGCCGGTA
CTGTTCACTTT -> TGTTCACTTTA
CTGTTGGCCAG -> TGTTGGCCAGA
CTTAAACCTAC -> TTAAACCTACC
CTTAACGGTTA -> TTAACGGTTAA
CTTAACTTAAT -> TTAACTTAATG
CTTAATGGCCA -> TTAATGGCCAC
CTTACCTTTCT -> TTACCTTTCTG
CTTATCCTATG -> TTATCCTATGT
CTTATTTTGTT -> TTATTTTGTTG
CTTCACAATTT -> TTCACAATTTG
CTTCAGCAAAA -> TTCAGCAAAAT
CTTCGCGGAGC -> TTCGCGGAGCT
CTTGAAGTGCT -> TTGAAGTGCTA
CTTGCGCACGC -> TTGCGCACGCC
CTTGCTATAAA -> TTGCTATAAAC
CTTGGGGTGGG -> TTGGGGTGGGC
CTTGGTTCAGC -> TTGGTTCAGCT
CTTGTAGTTGC -> TTGTAGTTGCT
CTTTAATAGGT -> TTTAATAGGTT
CTTTACACAAC -> TTTACACAACA
CTTTACCGGCG -> TTTACCGGCGA
CTTTAGAGTTT -> TTTAGAGTTTT
CTTTATCCGAA -> TTTATCCGAAG
CTTTATTACAG -> TTTATTACAGT
CTTTCGTTCTA -> TTTCGTTCTAG
CTTTCTGCGAC -> TTTCTGCGACT
CTTTGAAGCCA -> TTTGAAGCCAG
CTTTGAGTCAA -> TTTGAGTCAAA
GAAAATTACAG -> AAAATTACAGA
GAAACATATCC -> AAACATATCCT
GAAAGGCTGTC -> AAAGGCTGTCA
GAAATGTGCGA -> AAATGTGCGAA
GAACAAGGTGT -> AACAAGGTGTT
GAACCAATTAG -> AACCAATTAGA
GAACCGCCACG -> AACCGCCACGG
GAACGAACAAG -> AACGAACAAGG
GAACGCCGCGA -> AACGCCGCGAT
GAACGGGCCGG -> AACGGGCCGGT
GAAGCCAGTGT -> AAGCCAGTGTC
GAAGCCTATAA -> AAGCCTATAAT
GAAGCTAGGAT -> AAGCTAGGATA
GAAGGTCTTTA -> AAGGTCTTTAC
GAAGTAACACC -> AAGTAACACCG
GAAGTGCTAGG -> AAGTGCTAGGC
GAATACTATAG -> AATACTATAGT
GAATCAGCGGC -> AATCAGCGGCG
GAATGCCACCA -> AATGCCACCAC
GAATGGACCAG -> AATGGACCAGT
GAATGGACTTG -> AATGGACTTGG
GAATTGATTTC -> AATTGATTTCG
GACAAATACAT -> ACAAATACATC
GACAAGGCTCC -> ACAAGGCTCCA
GACAATCAGCC -> ACAATCAGCCA
GACACGACTTT -> ACACGACTTTG
GACAGGCCTCG -> ACAGGCCTCGA
GACAGGGTTGA -> ACAGGGTTGAG
GACAGGTGCCT -> ACAGGTGCCTC
GACATATATGC -> ACATATATGCT
GACATCCCGCG -> ACATCCCGCGC
GACCAGTAACC -> ACCAGTAACCC
GACCCAGCCGA -> ACCCAGCCGAG
GACCGATTGAC -> ACCGATTGACG
GACCGCCCTTG -> ACCGCCCTTGT
GACCGGCAAGT -> ACCGGCAAGTC
GACCGTGAGAA -> ACCGTGAGAAC
GACGAGACAAT -> ACGAGACAATC
GACGATATTGC -> ACGATATTGCC
GACGATTTGCT -> ACGATTTGCTT
GACGGCGCGTT -> ACGGCGCGTTA
GACGTCAGCTT -> ACGTCAGCTTT
GACGTGGGGAC -> ACGTGGGGACC
GACTCCCAGAG -> ACTCCCAGAGG
GACTCCCCGCC -> ACTCCCCGCCT
GACTCGGAGTC -> ACTCGGAGTCT
GACTTCGCGGA -> ACTTCGCGGAG
GACTTGGGGTG -> ACTTGGGGTGG
GACTTTGAAGC -> ACTTTGAAGCC
GACTTTGAGTC -> ACTTTGAGTCA
GAGAACGAACA -> AGAACGAACAA
GAGACAATCAG -> AGACAATCAGC
GAGACGATTTG -> AGACGATTTGC
GAGAGTAAGCC -> AGAGTAAGCCG
GAGAGTAGAAT -> AGAGTAGAATG
GAGCACGCCCT -> AGCACGCCCTC
GAGCAGGATAC -> AGCAGGATACA
GAGCCATCGAT -> AGCCATCGATC
GAGCGAGTAAT -> AGCGAGTAATG
GAGCTACCGAT -> AGCTACCGATT
GAGCTTCACAA -> AGCTTCACAAT
GAGGCATGTAA -> AGGCATGTAAC
GAGGCGGTCAC -> AGGCGGTCACC
GAGGGGACCCA -> AGGGGACCCAG
GAGGTATATAG -> AGGTATATAGG
GAGGTATATCT -> AGGTATATCTC
GAGGTGCGCAT -> AGGTGCGCATG
GAGGTTTAATG -> AGGTTTAATGG
GAGTAAGCCGG -> AGTAAGCCGGT
GAGTAATGCCA -> AGTAATGCCAC
GAGTACCCGAG -> AGTACCCGAGC
GAGTAGAATGC -> AGTAGAATGCC
GAGTCAAACTA -> AGTCAAACTAT
GAGTCACCCTG -> AGTCACCCTGG
GAGTCCCATGT -> AGTCCCATGTA
GAGTCTCTTAT -> AGTCTCTTATC
GAGTGACTTCG -> AGTGACTTCGC
GAGTGATTTTA -> AGTGATTTTAG
GAGTGGGCCTT -> AGTGGGCCTTG
GAGTTCAATTA -> AGTTCAATTAG
GAGTTTTTTTC -> AGTTTTTTTCC
GATAACTCCAT -> ATAACTCCATT
GATAAGACGGC -> ATAAGACGGCG
GATAAGCCCGG -> ATAAGCCCGGT
GATAAGTACTT -> ATAAGTACTTA
GATAATAAGTC -> ATAATAAGTCG
GATAATCGAGC -> ATAATCGAGCC
GATAATGAACC -> ATAATGAACCA
GATACAGAAGC -> ATACAGAAGCC
GATATAGTCAC -> ATATAGTCACA
GATATTGCCTG -> ATATTGCCTGC
GATCATCCCTG -> ATCATCCCTGT
GATCCTCAAGC -> ATCCTCAAGCC
GATCTATCTTC -> ATCTATCTTCA
GATCTTTAATA -> ATCTTTAATAG
GATGATAAGAC -> ATGATAAGACG
GATGATAAGCC -> ATGATAAGCCC
GATGCGGCGCT -> ATGCGGCGCTA
GATGTCTCTCC -> ATGTCTCTCCC
GATTAGGATAA -> ATTAGGATAAC
GATTATTCCTA -> ATTATTCCTAC
GATTCCGCACT -> ATTCCGCACTG
GATTGACGTGG -> ATTGACGTGGG
GATTTCGTGTT -> ATTTCGTGTTC
GATTTGCTTTC -> ATTTGCTTTCG
GATTTTAGCGC -> ATTTTAGCGCT
GCAAAATCAGC -> CAAAATCAGCG
GCAAACGAGCG -> CAAACGAGCGA
GCAAACGAGTC -> CAAACGAGTCA
GCAAGTCCGGT -> CAAGTCCGGTA
GCAATCCAGAC -> CAATCCAGACC
GCAATCTGAAT -> CAATCTGAATA
GCAATTAGGTA -> CAATTAGGTAA
GCACATCAAAA -> CACATCAAAAC
GCACCAATAAG -> CACCAATAAGC
GCACCCTACGT -> CACCCTACGTT
GCACGAGACGA -> CACGAGACGAT
GCACGCCCTCT -> CACGCCCTCTC
GCACGCCTTGC -> CACGCCTTGCT
GCACGGCACAT -> CACGGCACATC
GCACTGTATGG -> CACTGTATGGA
GCAGAGGCATG -> CAGAGGCATGT
GCAGATTATTC -> CAGATTATTCC
GCAGCGTTTAC -> CAGCGTTTACC
GCAGGATACAG -> CAGGATACAGA
GCAGTGGCACC -> CAGTGGCACCA
GCATCGAATTG -> CATCGAATTGA
GCATGAGTGAT -> CATGAGTGATT
GCATGTAACCT -> CATGTAACCTG
GCATTGGAGTA -> CATTGGAGTAC
GCCACATGAAG -> CCACATGAAGT
GCCACCACGGG -> CCACCACGGGT
GCCACGGTGCC -> CCACGGTGCCC
GCCACGTGCGC -> CCACGTGCGCA
GCCACTACTGT -> CCACTACTGTT
GCCAGAGTGGG -> CCAGAGTGGGC
GCCAGTGTCCG -> CCAGTGTCCGC
GCCATCGATCA -> CCATCGATCAT
GCCCCCGCTAC -> CCCCCGCTACC
GCCCGCTTAAC -> CCCGCTTAACG
GCCCGGTGGTC -> CCCGGTGGTCT
GCCCTCTCGCC -> CCCTCTCGCCC
GCCCTCTCTGT -> CCCTCTCTGTA
GCCCTTGTAGT -> CCCTTGTAGTT
GCCGAGTCCCA -> CCGAGTCCCAT
GCCGCGATATA -> CCGCGATATAG
GCCGGTAAATG -> CCGGTAAATGG
GCCGGTAAGTC -> CCGGTAAGTCA
GCCGGTTGGTC -> CCGGTTGGTCA
GCCGTAGGATT -> CCGTAGGATTA
GCCGTTTTGAT -> CCGTTTTGATG
GCCTAAGCAGA -> CCTAAGCAGAT
GCCTATAATGA -> CCTATAATGAC
GCCTATCCTTA -> CCTATCCTTAT
GCCTCAAGACG -> CCTCAAGACGT
GCCTCGACAAA -> CCTCGACAAAT
GCCTGCAATTA -> CCTGCAATTAG
GCCTTGCGCAC -> CCTTGCGCACG
GCCTTGCTATA -> CCTTGCTATAA
GCGAAAGGCTG -> CGAAAGGCTGT
GCGAAGGTCTT -> CGAAGGTCTTT
GCGACATATAT -> CGACATATATG
GCGACTCCCAG -> CGACTCCCAGA
GCGACTCCCCG -> CGACTCCCCGC
GCGAGGTATAT -> CGAGGTATATC
GCGAGTAATGC -> CGAGTAATGCC
GCGATATAGTC -> CGATATAGTCA
GCGCACGCCTT -> CGCACGCCTTG
GCGCAGAGGCA -> CGCAGAGGCAT
GCGCAGTGGCA -> CGCAGTGGCAC
GCGCATGAGTG -> CGCATGAGTGA
GCGCATTGGAG -> CGCATTGGAGT
GCGCGCAGAGG -> CGCGCAGAGGC
GCGCGTTACCC -> CGCGTTACCCG
GCGCTAAGACA -> CGCTAAGACAG
GCGCTCTGGTC -> CGCTCTGGTCA
GCGCTGTTGGC -> CGCTGTTGGCC
GCGCTTTAGAG -> CGCTTTAGAGT
GCGGAGCTTCA -> CGGAGCTTCAC
GCGGCGCTAAG -> CGGCGCTAAGA
GCGGCGGTTGG -> CGGCGGTTGGT
GCGGGAACGGG -> CGGGAACGGGC
GCGGGGCATCG -> CGGGGCATCGA
GCGGTCACCTA -> CGGTCACCTAT
GCGGTTGGTTG -> CGGTTGGTTGC
GCGTGCCGTAG -> CGTGCCGTAGG
GCGTTACCCGT -> CGTTACCCGTT
GCGTTTACCTG -> CGTTTACCTGT
GCTAAGACAGG -> CTAAGACAGGC,CTAAGACAGGG
GCTACCGATTC -> CTACCGATTCC
GCTACCTCAGT -> CTACCTCAGTC
GCTAGGATAAT -> CTAGGATAATA
GCTAGGCCTAA -> CTAGGCCTAAG
GCTATAAACGT -> CTATAAACGTA
GCTCAGAGAGT -> CTCAGAGAGTA
GCTCCAAGGGC -> CTCCAAGGGCA
GCTCCTCACTG -> CTCCTCACTGA
GCTCGGCAAAC -> CTCGGCAAACG
GCTCTGGTCAA -> CTCTGGTCAAG
GCTGGAGAGTA -> CTGGAGAGTAA
GCTGTCAGTAT -> CTGTCAGTATT
GCTGTGATAAG -> CTGTGATAAGT
GCTGTTGGCCA -> CTGTTGGCCAG
GCTTAACGGTT -> CTTAACGGTTA
GCTTAACTTAA -> CTTAACTTAAT
GCTTCACAATT -> CTTCACAATTT
GCTTTAGAGTT -> CTTTAGAGTTT
GCTTTATCCGA -> CTTTATCCGAA
GCTTTCGTTCT -> CTTTCGTTCTA
GGAACGGGCCG -> GAACGGGCCGG
GGAATGGACCA -> GAATGGACCAG
GGAATGGACTT -> GAATGGACTTG
GGACATCCCGC -> GACATCCCGCG
GGACCAGTAAC -> GACCAGTAACC
GGACCCAGCCG -> GACCCAGCCGA
GGACCGCCCTT -> GACCGCCCTTG
GGACCGGCAAG -> GACCGGCAAGT
GGACGATATTG -> GACGATATTGC
GGACTTGGGGT -> GACTTGGGGTG
GGAGAGTAAGC -> GAGAGTAAGCC
GGAGCTTCACA -> GAGCTTCACAA
GGAGGGGACCC -> GAGGGGACCCA
GGAGGTTTAAT -> GAGGTTTAATG
GGAGTACCCGA -> GAGTACCCGAG
GGAGTCTCTTA -> GAGTCTCTTAT
GGAGTTCAATT -> GAGTTCAATTA
GGATAACTCCA -> GATAACTCCAT
GGATAATAAGT -> GATAATAAGTC
GGATAATCGAG -> GATAATCGAGC
GGATACAGAAG -> GATACAGAAGC
GGATGCGGCGC -> GATGCGGCGCT
GGATTAGGATA -> GATTAGGATAA
GGCAAACGAGC -> GCAAACGAGCG
GGCAAGTCCGG -> GCAAGTCCGGT
GGCAATCCAGA -> GCAATCCAGAC
GGCACATCAAA -> GCACATCAAAA
GGCACCAATAA -> GCACCAATAAG
GGCACGGCACA -> GCACGGCACAT
GGCATCGAATT -> GCATCGAATTG
GGCATGTAACC -> GCATGTAACCT
GGCCACATGAA -> GCCACATGAAG
GGCCAGAGTGG -> GCCAGAGTGGG
GGCCGGTAAAT -> GCCGGTAAATG
GGCCGGTTGGT -> GCCGGTTGGTC
GGCCTAAGCAG -> GCCTAAGCAGA
GGCCTCGACAA -> GCCTCGACAAA
GGCCTTGCGCA -> GCCTTGCGCAC
GGCGACATATA -> GCGACATATAT
GGCGCGTTACC -> GCGCGTTACCC
GGCGCTAAGAC -> GCGCTAAGACA
GGCGGTCACCT -> GCGGTCACCTA
GGCGGTTGGTT -> GCGGTTGGTTG
GGCTAAGACAG -> GCTAAGACAGG
GGCTCCAAGGG -> GCTCCAAGGGC
GGCTGTCAGTA -> GCTGTCAGTAT
GGGAACGGGCC -> GGAACGGGCCG
GGGACCCAGCC -> GGACCCAGCCG
GGGACCGCCCT -> GGACCGCCCTT
GGGCAATCCAG -> GGCAATCCAGA
GGGCATCGAAT -> GGCATCGAATT
GGGCCGGTTGG -> GGCCGGTTGGT
GGGCCTTGCGC -> GGCCTTGCGCA
GGGCTAAGACA -> GGCTAAGACAG
GGGGACCCAGC -> GGGACCCAGCC
GGGGACCGCCC -> GGGACCGCCCT
GGGGCATCGAA -> GGGCATCGAAT
GGGGTGGGCTA -> GGGTGGGCTAA
GGGTAATCAGG -> GGTAATCAGGC
GGGTAGGACAT -> GGTAGGACATC
GGGTCCATTAG -> GGTCCATTAGC
GGGTCGGAGGT -> GGTCGGAGGTT
GGGTGGGCTAA -> GGTGGGCTAAG
GGGTGTGCGGG -> GGTGTGCGGGG
GGGTTCCGAGC -> GGTTCCGAGCT
GGGTTGAGGCG -> GGTTGAGGCGG
GGTAAATGGGT -> GTAAATGGGTG
GGTAAGTCAAA -> GTAAGTCAAAT
GGTAATCAGGC -> GTAATCAGGCA
GGTAATCTCAG -> GTAATCTCAGT
GGTACTTGGTT -> GTACTTGGTTC
GGTAGGACATC -> GTAGGACATCC
GGTATATAGGA -> GTATATAGGAA
GGTATATCTCA -> GTATATCTCAT
GGTCAAGAGCA -> GTCAAGAGCAG
GGTCACCTATA -> GTCACCTATAT
GGTCACTACTC -> GTCACTACTCC
GGTCCATTAGC -> GTCCATTAGCG
GGTCGGAGGTT -> GTCGGAGGTTT
GGTCTCGAAAT -> GTCTCGAAATG
GGTCTTTACCG -> GTCTTTACCGG
GGTGAGGTGCG -> GTGAGGTGCGC
GGTGCCCTCTC -> GTGCCCTCTCT
GGTGCCTCAAG -> GTGCCTCAAGA
GGTGCGAAGGT -> GTGCGAAGGTC
GGTGCGCATGA -> GTGCGCATGAG
GGTGGGCTAAG -> GTGGGCTAAGA
GGTGGTCTCGA -> GTGGTCTCGAA
GGTGTGCGGGG -> GTGTGCGGGGC
GGTGTTGGATG -> GTGTTGGATGC
GGTTAATTGAT -> GTTAATTGATC
GGTTAGAACGC -> GTTAGAACGCC
GGTTCAGCTTA -> GTTCAGCTTAA
GGTTCCGAGCT -> GTTCCGAGCTA
GGTTGAGGCGG -> GTTGAGGCGGT
GGTTGCTGGAG -> GTTGCTGGAGA
GGTTGGTCACT -> GTTGGTCACTA
GGTTGGTTGCT -> GTTGGTTGCTG
GGTTGTTTGCT -> GTTGTTTGCTC
GGTTTAATGGT -> GTTTAATGGTT
GTAAATGGGTG -> TAAATGGGTGT
GTAACACCGAC -> TAACACCGACG
GTAACAGTATA -> TAACAGTATAA
GTAACCCTAGC -> TAACCCTAGCA
GTAACCTGTCG -> TAACCTGTCGG
GTAAGCCGGTA -> TAAGCCGGTAA
GTAAGTCAAAT -> TAAGTCAAATA
GTAATCAGGCA -> TAATCAGGCAC
GTAATCTCAGT -> TAATCTCAGTC
GTAATGCCACT -> TAATGCCACTA
GTACCCGAGCA -> TACCCGAGCAC
GTACTAGATGA -> TACTAGATGAT
GTACTTACCTT -> TACTTACCTTT
GTACTTGGTTC -> TACTTGGTTCA
GTAGAATGCCA -> TAGAATGCCAC
GTAGCGGGAAC -> TAGCGGGAACG
GTAGGACATCC -> TAGGACATCCC
GTAGGATTAGG -> TAGGATTAGGA
GTAGGGTAGGA -> TAGGGTAGGAC
GTAGTTGCTCC -> TAGTTGCTCCT
GTATAAACTAG -> TATAAACTAGT
GTATAGTTCAT -> TATAGTTCATG
GTATATAGGAA -> TATATAGGAAT
GTATATCTCAT -> TATATCTCATG
GTATGGAGGGG -> TATGGAGGGGA
GTATTGTCACT -> TATTGTCACTA
GTCAAACTATT -> TCAAACTATTT
GTCAAATATGG -> TCAAATATGGG
GTCAAGAGCAG -> TCAAGAGCAGG
GTCACAGACAA -> TCACAGACAAG
GTCACCCTGGT -> TCACCCTGGTG
GTCACCTATAT -> TCACCTATATC
GTCACTAAGGT -> TCACTAAGGTG
GTCACTACTCC -> TCACTACTCCA
GTCACTTTACA -> TCACTTTACAC
GTCAGACTTTG -> TCAGACTTTGA
GTCAGCTTTAT -> TCAGCTTTATC
GTCAGGGTAAT -> TCAGGGTAATC
GTCAGTATTGT -> TCAGTATTGTC
GTCCAAACAAA -> TCCAAACAAAA
GTCCATTAGCG -> TCCATTAGCGA
GTCCCATGTAC -> TCCCATGTACT
GTCCGCGCTGT -> TCCGCGCTGTT
GTCCGGTACTT -> TCCGGTACTTG
GTCCTTGAAGT -> TCCTTGAAGTG
GTCGGAGGTTT -> TCGGAGGTTTA
GTCGGGTCGGA -> TCGGGTCGGAG
GTCGTTGCAAA -> TCGTTGCAAAC
GTCTCCAGGAT -> TCTCCAGGATA
GTCTCGAAATG -> TCTCGAAATGT
GTCTCTCCCCG -> TCTCTCCCCGT
GTCTCTTATCC -> TCTCTTATCCT
GTCTTTACCGG -> TCTTTACCGGC
GTGAACCGCCA -> TGAACCGCCAC
GTGACACGACT -> TGACACGACTT
GTGACTTCGCG -> TGACTTCGCGG
GTGAGAACGAA -> TGAGAACGAAC
GTGAGGTGCGC -> TGAGGTGCGCA
GTGATAAGTAC -> TGATAAGTACT
GTGATTTTAGC -> TGATTTTAGCG
GTGCCCTCTCT -> TGCCCTCTCTG
GTGCCGTAGGA -> TGCCGTAGGAT
GTGCCTCAAGA -> TGCCTCAAGAC
GTGCGAAAGGC -> TGCGAAAGGCT
GTGCGAAGGTC -> TGCGAAGGTCT
GTGCGCAGTGG -> TGCGCAGTGGC
GTGCGCATGAG -> TGCGCATGAGT
GTGCGGGGCAT -> TGCGGGGCATC
GTGCTAGGCCT -> TGCTAGGCCTA
GTGCTCAGAGA -> TGCTCAGAGAG
GTGGCACCAAT -> TGGCACCAATA
GTGGCCGGTAA -> TGGCCGGTAAA
GTGGGCCTTGC -> TGGGCCTTGCG
GTGGGCTAAGA -> TGGGCTAAGAC
GTGGGGACCGC -> TGGGGACCGCC
GTGGTCTCGAA -> TGGTCTCGAAA
GTGGTTGTTTG -> TGGTTGTTTGC
GTGTCCGCGCT -> TGTCCGCGCTG
GTGTGACACGA -> TGTGACACGAC
GTGTGCGGGGC -> TGTGCGGGGCA
GTGTTCAATGT -> TGTTCAATGTG
GTGTTGGATGC -> TGTTGGATGCG
GTTAATTGATC -> TTAATTGATCT
GTTACCCGTTC -> TTACCCGTTCA
GTTACTATGTG -> TTACTATGTGT
GTTAGAACGCC -> TTAGAACGCCG
GTTATGTCTCC -> TTATGTCTCCA
GTTCAATGTGG -> TTCAATGTGGT
GTTCAATTAGC -> TTCAATTAGCA
GTTCACCGGAC -> TTCACCGGACC
GTTCACTTTAT -> TTCACTTTATT
GTTCAGCTTAA -> TTCAGCTTAAC
GTTCATGATCT -> TTCATGATCTT
GTTCCGAGCTA -> TTCCGAGCTAC
GTTCTAGCAGC -> TTCTAGCAGCG
GTTGAGGCGGT -> TTGAGGCGGTC
GTTGCAAACGA -> TTGCAAACGAG
GTTGCCGTTTT -> TTGCCGTTTTG
GTTGCTCCTCA -> TTGCTCCTCAC
GTTGCTGGAGA -> TTGCTGGAGAG
GTTGGATGCGG -> TTGGATGCGGC
GTTGGCCAGAG -> TTGGCCAGAGT
GTTGGTCACTA -> TTGGTCACTAC
GTTGGTTGCTG -> TTGGTTGCTGG
GTTGTTATGTC -> TTGTTATGTCT
GTTGTTTGCTC -> TTGTTTGCTCG
GTTTAATGGTT -> TTTAATGGTTA
GTTTACCTGTA -> TTTACCTGTAG
GTTTGCTCGGC -> TTTGCTCGGCA
GTTTTGATGAT -> TTTTGATGATA
GTTTTTTTCCC -> TTTTTTTCCCG
TAAACCAAGAT -> AAACCAAGATA
TAAACCTACCA -> AAACCTACCAG
TAAACGTAACA -> AAACGTAACAG
TAAACTAGTCA -> AAACTAGTCAC
TAAATGGGTGT -> AAATGGGTGTG
TAACACCGACG -> AACACCGACGA
TAACAGTATAA -> AACAGTATAAA
TAACCCTAGCA -> AACCCTAGCAC
TAACCTGTCGG -> AACCTGTCGGG
TAACGGTTAAT -> AACGGTTAATT
TAACTCCATTT -> AACTCCATTTC
TAACTTAATGG -> AACTTAATGGC
TAAGACAGGCC -> AAGACAGGCCT
TAAGACAGGGT -> AAGACAGGGTT
TAAGACGGCGC -> AAGACGGCGCG
TAAGCAGATTA -> AAGCAGATTAT
TAAGCCCGGTG -> AAGCCCGGTGG
TAAGCCGGTAA -> AAGCCGGTAAG
TAAGCGTGCCG -> AAGCGTGCCGT
TAAGGTGAGGT -> AAGGTGAGGTG
TAAGTACTTAC -> AAGTACTTACC
TAAGTCAAATA -> AAGTCAAATAT
TAAGTCGTTGC -> AAGTCGTTGCA
TAATAAGTCGT -> AATAAGTCGTT
TAATAGGTTTA -> AATAGGTTTAC
TAATCAGGCAC -> AATCAGGCACG
TAATCGAGCCA -> AATCGAGCCAT
TAATCTCAGTC -> AATCTCAGTCC
TAATGAACCAA -> AATGAACCAAT
TAATGACTCGG -> AATGACTCGGA
TAATGCCACTA -> AATGCCACTAC
TAATGGCCACA -> AATGGCCACAT
TAATGGTTAGA -> AATGGTTAGAA
TAATTGATCTA -> AATTGATCTAT
TACACAACATA -> ACACAACATAC
TACAGAAGCCT -> ACAGAAGCCTA
TACAGATGTCT -> ACAGATGTCTC
TACAGTGCTCA -> ACAGTGCTCAG
TACATCCGCGC -> ACATCCGCGCG
TACATTAAACC -> ACATTAAACCA
TACCAGGAGTT -> ACCAGGAGTTC
TACCCGAGCAC -> ACCCGAGCACG
TACCCGTTCAC -> ACCCGTTCACC
TACCGATTCCG -> ACCGATTCCGC
TACCGGCGACA -> ACCGGCGACAT
TACCTCAGTCC -> ACCTCAGTCCA
TACCTGTAGCG -> ACCTGTAGCGG
TACCTTTCTGC -> ACCTTTCTGCG
TACGGACGATA -> ACGGACGATAT
TACGTTACTAT -> ACGTTACTATG
TACTAGATGAT -> ACTAGATGATA
TACTATAGTCA -> ACTATAGTCAG
TACTATGTGTG -> ACTATGTGTGA
TACTCCAAGTA -> ACTCCAAGTAG
TACTGTTCACT -> ACTGTTCACTT
TACTTACCTTT -> ACTTACCTTTC
TACTTGGTTCA -> ACTTGGTTCAG
TAGAACGCCGC -> AGAACGCCGCG
TAGAATGCCAC -> AGAATGCCACC
TAGACAGGTGC -> AGACAGGTGCC
TAGAGTTTTTT -> AGAGTTTTTTT
TAGATGATAAG -> AGATGATAAGC
TAGCACCCTAC -> AGCACCCTACG
TAGCACGAGAC -> AGCACGAGACG
TAGCAGCGTTT -> AGCAGCGTTTA
TAGCGAGGTAT -> AGCGAGGTATA
TAGCGCTTTAG -> AGCGCTTTAGA
TAGCGGGAACG -> AGCGGGAACGG
TAGGAATGGAC -> AGGAATGGACT
TAGGACATCCC -> AGGACATCCCG
TAGGATAACTC -> AGGATAACTCC
TAGGATAATAA -> AGGATAATAAG
TAGGATTAGGA -> AGGATTAGGAT
TAGGCCTAAGC -> AGGCCTAAGCA
TAGGGTAGGAC -> AGGGTAGGACA
TAGGTAATCTC -> AGGTAATCTCA
TAGTCACAGAC -> AGTCACAGACA
TAGTCACTTTA -> AGTCACTTTAC
TAGTCAGGGTA -> AGTCAGGGTAA
TAGTTCATGAT -> AGTTCATGATC
TAGTTGCTCCT -> AGTTGCTCCTC
TATAAACGTAA -> ATAAACGTAAC
TATAAACTAGT -> ATAAACTAGTC
TATAATGACTC -> ATAATGACTCG
TATAGGAATGG -> ATAGGAATGGA
TATAGTCACAG -> ATAGTCACAGA
TATAGTCAGGG -> ATAGTCAGGGT
TATAGTTCATG -> ATAGTTCATGA
TATATAGGAAT -> ATATAGGAATG
TATATCATGAT -> ATATCATGATC
TATATCTCATG -> ATATCTCATGT
TATATGCTGTG -> ATATGCTGTGA
TATCATGATCC -> ATCATGATCCT
TATCCGAAGCT -> ATCCGAAGCTA
TATCCTATGTG -> ATCCTATGTGA
TATCCTTAAAC -> ATCCTTAAACC
TATCCTTATTT -> ATCCTTATTTT
TATCTCATGTC -> ATCTCATGTCA
TATCTTCAGCA -> ATCTTCAGCAA
TATGCTGTGAT -> ATGCTGTGATA
TATGGAGGGGA -> ATGGAGGGGAC
TATGGGTTCCG -> ATGGGTTCCGA
TATGTCTCCAG -> ATGTCTCCAGG
TATGTGAACCG -> ATGTGAACCGC
TATGTGTGACA -> ATGTGTGACAC
TATTACAGTGC -> ATTACAGTGCT
TATTCCTACAT -> ATTCCTACATT
TATTGCCTGCA -> ATTGCCTGCAA
TATTGTCACTA -> ATTGTCACTAA
TATTTTGCGCT -> ATTTTGCGCTC
TATTTTGTTGC -> ATTTTGTTGCC
TCAAAACAGAA -> CAAAACAGAAA
TCAAACTATTT -> CAAACTATTTT
TCAAATATGGG -> CAAATATGGGT
TCAAGACGTCA -> CAAGACGTCAG
TCAAGAGCAGG -> CAAGAGCAGGA
TCAAGCCCGCT -> CAAGCCCGCTT
TCAATGTGGTT -> CAATGTGGTTG
TCAATTAGCAC -> CAATTAGCACC
TCACAATTTGG -> CACAATTTGGA
TCACAGACAAG -> CACAGACAAGG
TCACCCTGGTG -> CACCCTGGTGC
TCACCGGACCG -> CACCGGACCGG
TCACCTATATC -> CACCTATATCA
TCACTAAGGTG -> CACTAAGGTGA
TCACTACTCCA -> CACTACTCCAA
TCACTGACCGT -> CACTGACCGTG
TCACTTTACAC -> CACTTTACACA
TCACTTTATTA -> CACTTTATTAC
TCAGACTTTGA -> CAGACTTTGAG
TCAGAGAGTAG -> CAGAGAGTAGA
TCAGCAAAATC -> CAGCAAAATCA
TCAGCCACGTG -> CAGCCACGTGC
TCAGCGACTCC -> CAGCGACTCCC
TCAGCGGCGGT -> CAGCGGCGGTT
TCAGCTTAACT -> CAGCTTAACTT
TCAGCTTTATC -> CAGCTTTATCC
TCAGGCACGGC -> CAGGCACGGCA
TCAGGGTAATC -> CAGGGTAATCA
TCAGTATTGTC -> CAGTATTGTCA
TCAGTCCAAAC -> CAGTCCAAACA
TCAGTCCTTGA -> CAGTCCTTGAA
TCATCCCTGTG -> CATCCCTGTGG
TCATGATCCTC -> CATGATCCTCA
TCATGATCTTT -> CATGATCTTTA
TCATGTCAGAC -> CATGTCAGACT
TCCAAACAAAA -> CCAAACAAAAC
TCCAAGGGCAA -> CCAAGGGCAAT
TCCAAGTAGGG -> CCAAGTAGGGT
TCCAGACCGAT -> CCAGACCGATT
TCCAGGATAAT -> CCAGGATAATC
TCCATTAGCGA -> CCATTAGCGAG
TCCATTTCTGA -> CCATTTCTGAA
TCCCAGAGGTA -> CCCAGAGGTAT
TCCCATGTACT -> CCCATGTACTA
TCCCCGCCTAT -> CCCCGCCTATC
TCCCCGTTGTT -> CCCCGTTGTTA
TCCCGCAATCT -> CCCGCAATCTG
TCCCGCGCATT -> CCCGCGCATTG
TCCCTGTGGCC -> CCCTGTGGCCG
TCCGAAGCTAG -> CCGAAGCTAGG
TCCGAGCTACC -> CCGAGCTACCG
TCCGCACTGTA -> CCGCACTGTAT
TCCGCGCGCAG -> CCGCGCGCAGA
TCCGCGCTGTT -> CCGCGCTGTTG
TCCGGTACTTG -> CCGGTACTTGG
TCCTACATTAA -> CCTACATTAAA
TCCTATGTGAA -> CCTATGTGAAC
TCCTCAAGCCC -> CCTCAAGCCCG
TCCTCACTGAC -> CCTCACTGACC
TCCTTAAACCT -> CCTTAAACCTA
TCCTTATTTTG -> CCTTATTTTGT
TCCTTGAAGTG -> CCTTGAAGTGC
TCGAAATGTGC -> CGAAATGTGCG
TCGAATTGATT -> CGAATTGATTT
TCGACAAATAC -> CGACAAATACA
TCGAGCCATCG -> CGAGCCATCGA
TCGATCATCCC -> CGATCATCCCT
TCGCCCCCGCT -> CGCCCCCGCTA
TCGCGGAGCTT -> CGCGGAGCTTC
TCGGAGGTTTA -> CGGAGGTTTAA
TCGGAGTCTCT -> CGGAGTCTCTT
TCGGCAAACGA -> CGGCAAACGAG
TCGGGTCGGAG -> CGGGTCGGAGG
TCGTGTTCAAT -> CGTGTTCAATG
TCGTTCTAGCA -> CGTTCTAGCAG
TCGTTGCAAAC -> CGTTGCAAACG
TCTAGCAGCGT -> CTAGCAGCGTT
TCTATCTTCAG -> CTATCTTCAGC
TCTCAGTCCTT -> CTCAGTCCTTG
TCTCATGTCAG -> CTCATGTCAGA
TCTCCAGGATA -> CTCCAGGATAA
TCTCCCCGTTG -> CTCCCCGTTGT
TCTCGAAATGT -> CTCGAAATGTG
TCTCGCCCCCG -> CTCGCCCCCGC
TCTCTCCCCGT -> CTCTCCCCGTT
TCTCTGTATAG -> CTCTGTATAGT
TCTCTTATCCT -> CTCTTATCCTA
TCTGAATACTA -> CTGAATACTAT
TCTGAATCAGC -> CTGAATCAGCG
TCTGCGACTCC -> CTGCGACTCCC
TCTGGTCAAGA -> CTGGTCAAGAG
TCTGTATAGTT -> CTGTATAGTTC
TCTTATCCTAT -> CTTATCCTATG
TCTTCAGCAAA -> CTTCAGCAAAA
TCTTTAATAGG -> CTTTAATAGGT
TCTTTACCGGC -> CTTTACCGGCG
TGAACCAATTA -> GAACCAATTAG
TGAACCGCCAC -> GAACCGCCACG
TGAAGCCAGTG -> GAAGCCAGTGT
TGAAGTAACAC -> GAAGTAACACC
TGAAGTGCTAG -> GAAGTGCTAGG
TGAATACTATA -> GAATACTATAG
TGAATCAGCGG -> GAATCAGCGGC
TGACACGACTT -> GACACGACTTT
TGACCGTGAGA -> GACCGTGAGAA
TGACGTGGGGA -> GACGTGGGGAC
TGACTCGGAGT -> GACTCGGAGTC
TGACTTCGCGG -> GACTTCGCGGA
TGAGAACGAAC -> GAGAACGAACA
TGAGGCGGTCA -> GAGGCGGTCAC
TGAGGTGCGCA -> GAGGTGCGCAT
TGAGTCAAACT -> GAGTCAAACTA
TGAGTGACTTC -> GAGTGACTTCG
TGAGTGATTTT -> GAGTGATTTTA
TGATAAGACGG -> GATAAGACGGC
TGATAAGCCCG -> GATAAGCCCGG
TGATAAGTACT -> GATAAGTACTT
TGATCCTCAAG -> GATCCTCAAGC
TGATCTATCTT -> GATCTATCTTC
TGATCTTTAAT -> GATCTTTAATA
TGATGATAAGA -> GATGATAAGAC
TGATTTCGTGT -> GATTTCGTGTT
TGATTTTAGCG -> GATTTTAGCGC
TGCAAACGAGT -> GCAAACGAGTC
TGCAATTAGGT -> GCAATTAGGTA
TGCCACCACGG -> GCCACCACGGG
TGCCACTACTG -> GCCACTACTGT
TGCCCTCTCTG -> GCCCTCTCTGT
TGCCGTAGGAT -> GCCGTAGGATT
TGCCGTTTTGA -> GCCGTTTTGAT
TGCCTCAAGAC -> GCCTCAAGACG
TGCCTGCAATT -> GCCTGCAATTA
TGCGAAAGGCT -> GCGAAAGGCTG
TGCGAAGGTCT -> GCGAAGGTCTT
TGCGACTCCCA -> GCGACTCCCAG
TGCGCACGCCT -> GCGCACGCCTT
TGCGCAGTGGC -> GCGCAGTGGCA
TGCGCATGAGT -> GCGCATGAGTG
TGCGCTCTGGT -> GCGCTCTGGTC
TGCGGCGCTAA -> GCGGCGCTAAG
TGCGGGGCATC -> GCGGGGCATCG
TGCTAGGCCTA -> GCTAGGCCTAA
TGCTATAAACG -> GCTATAAACGT
TGCTCAGAGAG -> GCTCAGAGAGT
TGCTCCTCACT -> GCTCCTCACTG
TGCTCGGCAAA -> GCTCGGCAAAC
TGCTGGAGAGT -> GCTGGAGAGTA
TGCTGTGATAA -> GCTGTGATAAG
TGCTTTCGTTC -> GCTTTCGTTCT
TGGAATGGACC -> GGAATGGACCA
TGGACCAGTAA -> GGACCAGTAAC
TGGACTTGGGG -> GGACTTGGGGT
TGGAGAGTAAG -> GGAGAGTAAGC
TGGAGGGGACC -> GGAGGGGACCC
TGGAGTACCCG -> GGAGTACCCGA
TGGATGCGGCG -> GGATGCGGCGC
TGGCACCAATA -> GGCACCAATAA
TGGCCACATGA -> GGCCACATGAA
TGGCCAGAGTG -> GGCCAGAGTGG
TGGCCGGTAAA -> GGCCGGTAAAT
TGGGCCTTGCG -> GGGCCTTGCGC
TGGGCTAAGAC -> GGGCTAAGACA
TGGGGACCGCC -> GGGGACCGCCC
TGGGGTGGGCT -> GGGGTGGGCTA
TGGGTGTGCGG -> GGGTGTGCGGG
TGGGTTCCGAG -> GGGTTCCGAGC
TGGTCAAGAGC -> GGTCAAGAGCA
TGGTCACTACT -> GGTCACTACTC
TGGTCTCGAAA -> GGTCTCGAAAT
TGGTGCGAAGG -> GGTGCGAAGGT
TGGTTAGAACG -> GGTTAGAACGC
TGGTTCAGCTT -> GGTTCAGCTTA
TGGTTGCTGGA -> GGTTGCTGGAG
TGGTTGTTTGC -> GGTTGTTTGCT
TGTAACCTGTC -> GTAACCTGTCG
TGTACTAGATG -> GTACTAGATGA
TGTAGCGGGAA -> GTAGCGGGAAC
TGTAGTTGCTC -> GTAGTTGCTCC
TGTATAGTTCA -> GTATAGTTCAT
TGTATGGAGGG -> GTATGGAGGGG
TGTCACTAAGG -> GTCACTAAGGT
TGTCAGACTTT -> GTCAGACTTTG
TGTCAGTATTG -> GTCAGTATTGT
TGTCCGCGCTG -> GTCCGCGCTGT
TGTCGGGTCGG -> GTCGGGTCGGA
TGTCTCCAGGA -> GTCTCCAGGAT
TGTCTCTCCCC -> GTCTCTCCCCG
TGTGAACCGCC -> GTGAACCGCCA
TGTGACACGAC -> GTGACACGACT
TGTGATAAGTA -> GTGATAAGTAC
TGTGCGAAAGG -> GTGCGAAAGGC
TGTGCGGGGCA -> GTGCGGGGCAT
TGTGGCCGGTA -> GTGGCCGGTAA
TGTGGTTGTTT -> GTGGTTGTTTG
TGTGTGACACG -> GTGTGACACGA
TGTTATGTCTC -> GTTATGTCTCC
TGTTCAATGTG -> GTTCAATGTGG
TGTTCACTTTA -> GTTCACTTTAT
TGTTGCCGTTT -> GTTGCCGTTTT
TGTTGGATGCG -> GTTGGATGCGG
TGTTGGCCAGA -> GTTGGCCAGAG
TGTTTGCTCGG -> GTTTGCTCGGC
TTAAACCAAGA -> TAAACCAAGAT
TTAAACCTACC -> TAAACCTACCA
TTAACGGTTAA -> TAACGGTTAAT
TTAACTTAATG -> TAACTTAATGG
TTAATAGGTTT -> TAATAGGTTTA
TTAATGGCCAC -> TAATGGCCACA
TTAATGGTTAG -> TAATGGTTAGA
TTAATTGATCT -> TAATTGATCTA
TTACACAACAT -> TACACAACATA
TTACAGATGTC -> TACAGATGTCT
TTACAGTGCTC -> TACAGTGCTCA
TTACCCGTTCA -> TACCCGTTCAC
TTACCGGCGAC -> TACCGGCGACA
TTACCTGTAGC -> TACCTGTAGCG
TTACCTTTCTG -> TACCTTTCTGC
TTACTATGTGT -> TACTATGTGTG
TTAGAACGCCG -> TAGAACGCCGC
TTAGACAGGTG -> TAGACAGGTGC
TTAGAGTTTTT -> TAGAGTTTTTT
TTAGCACCCTA -> TAGCACCCTAC
TTAGCGAGGTA -> TAGCGAGGTAT
TTAGCGCTTTA -> TAGCGCTTTAG
TTAGGATAACT -> TAGGATAACTC
TTAGGTAATCT -> TAGGTAATCTC
TTATCCGAAGC -> TATCCGAAGCT
TTATCCTATGT -> TATCCTATGTG
TTATGTCTCCA -> TATGTCTCCAG
TTATTACAGTG -> TATTACAGTGC
TTATTCCTACA -> TATTCCTACAT
TTATTTTGTTG -> TATTTTGTTGC
TTCAATGTGGT -> TCAATGTGGTT
TTCAATTAGCA -> TCAATTAGCAC
TTCACAATTTG -> TCACAATTTGG
TTCACCGGACC -> TCACCGGACCG
TTCACTTTATT -> TCACTTTATTA
TTCAGCAAAAT -> TCAGCAAAATC
TTCAGCTTAAC -> TCAGCTTAACT
TTCATGATCTT -> TCATGATCTTT
TTCCCGCAATC -> TCCCGCAATCT
TTCCGAGCTAC -> TCCGAGCTACC
TTCCGCACTGT -> TCCGCACTGTA
TTCCTACATTA -> TCCTACATTAA
TTCGCGGAGCT -> TCGCGGAGCTT
TTCGTGTTCAA -> TCGTGTTCAAT
TTCGTTCTAGC -> TCGTTCTAGCA
TTCTAGCAGCG -> TCTAGCAGCGT
TTCTGAATCAG -> TCTGAATCAGC
TTCTGCGACTC -> TCTGCGACTCC
TTGAAGCCAGT -> TGAAGCCAGTG
TTGAAGTGCTA -> TGAAGTGCTAG
TTGACGTGGGG -> TGACGTGGGGA
TTGAGGCGGTC -> TGAGGCGGTCA
TTGAGTCAAAC -> TGAGTCAAACT
TTGATCTATCT -> TGATCTATCTT
TTGATGATAAG -> TGATGATAAGA
TTGATTTCGTG -> TGATTTCGTGT
TTGCAAACGAG -> TGCAAACGAGT
TTGCCGTTTTG -> TGCCGTTTTGA
TTGCCTGCAAT -> TGCCTGCAATT
TTGCGCACGCC -> TGCGCACGCCT
TTGCGCTCTGG -> TGCGCTCTGGT
TTGCTATAAAC -> TGCTATAAACG
TTGCTCCTCAC -> TGCTCCTCACT
TTGCTCGGCAA -> TGCTCGGCAAA
TTGCTGGAGAG -> TGCTGGAGAGT
TTGCTTTCGTT -> TGCTTTCGTTC
TTGGAATGGAC -> TGGAATGGACC
TTGGAGTACCC -> TGGAGTACCCG
TTGGATGCGGC -> TGGATGCGGCG
TTGGCCAGAGT -> TGGCCAGAGTG
TTGGGGTGGGC -> TGGGGTGGGCT
TTGGTCACTAC -> TGGTCACTACT
TTGGTTCAGCT -> TGGTTCAGCTT
TTGGTTGCTGG -> TGGTTGCTGGA
TTGTAGTTGCT -> TGTAGTTGCTC
TTGTCACTAAG -> TGTCACTAAGG
TTGTTATGTCT -> TGTTATGTCTC
TTGTTGCCGTT -> TGTTGCCGTTT
TTGTTTGCTCG -> TGTTTGCTCGG
TTTAATAGGTT -> TTAATAGGTTT
TTTAATGGTTA -> TTAATGGTTAG
TTTACACAACA -> TTACACAACAT
TTTACCGGCGA -> TTACCGGCGAC
TTTACCTGTAG -> TTACCTGTAGC
TTTAGAGTTTT -> TTAGAGTTTTT
TTTAGCGCTTT -> TTAGCGCTTTA
TTTATCCGAAG -> TTATCCGAAGC
TTTATTACAGT -> TTATTACAGTG
TTTCCCGCAAT -> TTCCCGCAATC
TTTCGTGTTCA -> TTCGTGTTCAA
TTTCGTTCTAG -> TTCGTTCTAGC
TTTCTGAATCA -> TTCTGAATCAG
TTTCTGCGACT -> TTCTGCGACTC
TTTGAAGCCAG -> TTGAAGCCAGT
TTTGAGTCAAA -> TTGAGTCAAAC
TTTGATGATAA -> TTGATGATAAG
TTTGCGCTCTG -> TTGCGCTCTGG
TTTGCTCGGCA -> TTGCTCGGCAA
TTTGCTTTCGT -> TTGCTTTCGTT
TTTGGAATGGA -> TTGGAATGGAC
TTTGTTGCCGT -> TTGTTGCCGTT
TTTTAGCGCTT -> TTTAGCGCTTT
TTTTCCCGCAA -> TTTCCCGCAAT
TTTTGATGATA -> TTTGATGATAA
TTTTGCGCTCT -> TTTGCGCTCTG
TTTTGTTGCCG -> TTTGTTGCCGT
TTTTTCCCGCA -> TTTTCCCGCAA
TTTTTTCCCGC -> TTTTTCCCGCA
TTTTTTTCCCG -> TTTTTTCCCGC